state,institution,cares_act,omnibus,american_rescue_act,total_relief,endowment
AZ,Arizona State University,63533137,112906424,197920000,374359561,922000000
FL,Miami Dade College,49074737,100313671,175095000,324483408,486000000
FL,University Of Central Florida,51071250,88785992,155326000,295183242,162000000
PA,Pennsylvania State University (The),54994846,84967674,149782000,289744520,4000000000
NJ,"Rutgers, The State University Of New Jersey",54160640,83956947,147525000,285642587,1476000000
IN,Ivy Tech Community College Of Indiana,33040571,87521884,154176000,274738455,0
GA,Georgia State University,45243852,81991625,143227000,270462477,170800000
CA,"California State University, Northridge",44652328,74004088,128804000,247460416,119000000
FL,Florida International University,38301957,70899027,124068000,233268984,218700000
CA,"California State University, Fullerton",41021512,67736949,118108000,226866461,81700000
CA,"California State University, Long Beach",41729439,67421424,117424000,226574863,79400000
OH,Ohio State University (The),42885215,65158493,115136000,223179708,5290000000
TX,Texas A&M University,39816443,61084220,108020000,208920663,13514528000
CA,"California State University, Los Angeles",37914166,61905561,107504000,207323727,46200000
TX,University Of Houston,36703283,61804527,108166000,206673810,960000000
TX,Houston Community College,28294391,64722987,113378000,206395378,10200000
WA,University Of Washington - Seattle,39715956,59684404,105672000,205072360,6000000000
TX,Lone Star College System,28823255,63217876,111568000,203609131,0
CA,California State University - Sacramento,35734362,59891260,104257000,199882622,51200000
FL,University Of South Florida,34839748,58187541,102066000,195093289,532000000
TX,University Of Texas - Rio Grande Valley,34334258,58007276,100923000,193264534,46130000
FL,Valencia College,27682203,59512739,104037000,191231942,72500000
FL,Broward College,27154901,58986552,103056000,189197453,62200000
CA,"University Of California, Irvine",36731629,54737221,95771000,187239850,1030000000
CA,"University Of California, Los Angeles",35906870,52623807,92570000,181100677,5390000000
CA,"University Of California, San Diego",34889769,52015747,91170000,178075516,2300000000
NY,Cuny Borough Of Manhattan Community College,26420828,55218492,95999000,177638320,0
CA,"California State University, Fresno",32802107,52725317,91631000,177158424,170800000
CA,"University Of California, Davis",33871763,51521569,90298000,175691332,1660000000
TX,Texas State University,31791509,52142552,91252000,175186061,95400000
UT,Brigham Young University,32272986,50333740,88121000,170727726,1970000000
FL,University Of Florida,31046411,49578739,87513000,168138150,1850000000
TX,University Of Texas At San Antonio,29656887,49567034,86529000,165752921,172000000
TX,University Of Texas At Austin,31462321,48376958,85475000,165314279,30100000000
CA,"California State Polytechnic University, Pomona",30904089,48614353,84673000,164191442,101599000
AZ,University Of Arizona,30953447,47971859,84385000,163310306,1038133000
TX,University Of North Texas,29018088,47854595,83851000,160723683,210624000
TX,Tarrant County College District,21984486,49701915,87484000,159170401,0
CA,San Francisco State University,28725948,47404409,82743000,158873357,137080000
IL,University Of Illinois,29874590,47074555,81725000,158674145,2353821000
CA,"University Of California, Riverside",29734626,46440300,80888000,157062926,259800000
CA,San Jose State University,28769546,46631939,81613000,157014485,153212000
MI,Michigan State University,29836588,45964753,80773000,156574341,3033279000
GA,Kennesaw State University,27911927,46559603,81512000,155983530,40300000
CA,"University Of California, Berkeley",30440627,45429825,80102000,155972452,2070905000
CA,San Diego State University,29394934,45914127,80465000,155774061,353334000
IL,University Of Illinois ,31448178,44619241,79046000,155113419,2353821000
FL,Florida State University,29339828,45382413,79899000,154621241,704106000
PA,Temple University,28740378,44242362,77788000,150770740,644089000
UT,Utah Valley University,22949207,45611519,79919000,148479726,34800000
TX,University Of Texas At El Paso,24827599,43769137,76258000,144854736,241700000
CA,"California State University, San Bernardino",26243781,42438131,73768000,142449912,44900000
VA,Northern Virginia Community College,20028703,44142743,77919000,142090446,0
MN,University Of Minnesota,25794123,40211125,71645000,137650248,3951464000
TX,South Texas College,20022398,42189602,73775000,135987000,0
TX,Texas Tech University,25515252,39788865,69984000,135288117,1316660000
FL,Keiser University,21190626,41666816,71133000,133990442,0
NC,University Of North Carolina at Charlotte,24310557,39537542,69257000,133105099,230352000
OH,University Of Cincinnati,23527312,39288631,69416000,132231943,1453000000
FL,Florida Atlantic University,22429874,39909756,69874000,132213630,227520000
FL,Palm Beach State College,18933435,40897446,71541000,131371881,19300000
NV,University Of Nevada,23685293,38673077,67843000,130201370,377446000
CA,"University Of California, Santa Barbara",25204196,38078709,66653000,129935905,403000000
NY,New York University,25626944,37413437,66798000,129838381,4345608000
PR,Universidad Ana G. Méndez - Gurabo Campus,21074293,37352341,70523000,128949634,263000000
TX,University Of Texas At Arlington,21177188,38549079,67807000,127533267,159000000
AZ,Northern Arizona University,23577854,37511826,65713000,126802680,192621000
MI,University Of Michigan,25244052,36174408,64414000,125832460,12448817000
IN,Indiana University ,24572922,35998136,63810000,124381058,2486037000
NY,State University Of New York At Buffalo,23952900,36082991,63486000,123521891,794000000
GA,Georgia Southern University,22748221,36537745,63946000,123231966,56324000
GA,University Of Georgia,23704129,35659597,63171000,122534726,1343987000
VA,George Mason University,20855024,36198204,63918000,120971228,113199000
OH,Kent State University,19307244,36699722,64739000,120745966,141403000
VA,Liberty University,15205124,37777577,66300000,119282701,1587919000
ID,Brigham Young University Idaho,18172623,36367051,63904000,118443674,103000000
WA,Washington State University,21768544,34967964,61437000,118173508,1067842000
TX,El Paso Community College,16590145,36278737,63448000,116316882,0
IN,Purdue University,22588795,33443017,59507000,115538812,2625278000
IN,Indiana University - Purdue University Indianapolis,20919345,33894635,59581000,114394980,691300000
MD,"University Of Maryland, College Park",21490713,32838845,58245000,112574558,1436000000
FL,Hillsborough Community College,16262267,34912041,61096000,112270308,7219000
CA,Mount San Antonio College,17457959,34267707,60168000,111893666,0
IA,Iowa State University Of Science and Technology,21698857,32442265,57329000,111470122,1101709000
NY,Cuny Hunter College,19006958,33557126,58696000,111260084,136000000
CT,University Of Connecticut,21500845,32098504,56616000,110215349,462375000
MI,Wayne State University,19306183,32377451,56885000,108568634,394509000
VA,Virginia Commonwealth University,20288998,31937228,56234000,108460226,2042520000
SC,University Of South Carolina,21415130,31224416,55306000,107945546,788261000
AL,University Of Alabama,20722538,31436739,55688000,107847277,1519595000
NJ,Montclair State University,19911482,31667908,55356000,106935390,79490000
CA,"California State University, Chico",19959391,31603856,55070000,106633247,62900000
NV,College Of Southern Nevada,14078408,33500005,58831000,106409413,6160000
PA,University Of Pittsburgh,21265340,30614591,54308000,106187931,4311387000
CA,"California State University, Dominguez Hills",18481277,31843563,55383000,105707840,12543000
NH,Southern New Hampshire University,5494008,36406842,63789000,105689850,16700000
TX,Austin Community College,13907800,32959121,58237000,105103921,0
WV,West Virginia University,20174232,30727088,54131000,105032320,611300000
PR,University Of Puerto Rico - Mayaguez,19658125,31050892,53894000,104603017,256000000
UT,University Of Utah,18725330,30775179,54368000,103868509,1225045000
NY,State University Of New York At Stony Brook,19710714,30468755,53591000,103770469,265000000
TX,University Of Texas At Dallas,19132188,30612137,53908000,103652325,603000000
NC,East Carolina University,19358758,30548181,53586000,103492939,212566000
PA,Community College Of Philadelphia,16102431,31849546,55421000,103372977,0
NY,Cuny Brooklyn College,17627330,31206205,54429000,103262535,86100000
FL,Florida State College At Jacksonville,14500515,32230437,56479000,103209952,41000000
NM,University Of New Mexico,17266512,31124648,54682000,103073160,457313000
WI,University Of Wisconsin,19783001,29783409,53184000,102750410,3152578000
CA,University Of Southern California,19278560,29961264,53492000,102731824,5732101000
UT,Utah State University,17428745,30735450,53875000,102039195,402862000
OH,Ohio University,19475431,29578885,52303000,101357316,580657000
NC,University Of North Carolina Greensboro,18567881,30132331,52590000,101290212,310300000
OR,Portland State University,16640405,30740104,53908000,101288509,80341000
NY,New York City College Of Technology Of The City University Of New York,16209328,30860066,53731000,100800394,12000000
TN,University Of Tennessee,19258313,29330189,51731000,100319502,1354756000
PR,Universidad Ana G. Méndez - Cupey Campus,17052692,29487643,53314000,99854335,263000000
LA,Louisiana State University Agricultural & Mechanical College,18882288,29264189,51689000,99835477,521800000
CA,"University Of California, Santa Cruz",19327201,28784842,50385000,98497043,215400000
CO,University Of Colorado,18732408,28660299,50917000,98309707,1452722000
MI,Grand Valley State University,18333428,28990835,50943000,98267263,132091000
CA,Pasadena City College,15230050,30076671,52854000,98160721,0
NY,Cuny Queens College,16736798,29491179,51556000,97783977,85000000
CA,Long Beach City College,14663058,30001059,52555000,97219117,15000000
TN,Middle Tennessee State University,17299411,28959281,50677000,96935692,105575000
VA,Virginia Tech,19398987,27790518,49426000,96615505,1357969000
TX,Sam Houston State University,17468204,28732181,50220000,96420385,116921000
MA,University Of Massachusetts - Amherst,18335243,28151583,49744000,96230826,0
CO,Colorado State University,17693711,28296524,50028000,96018235,376063000
NC,NC State University,17895881,28156562,49914000,95966443,1400655000
WI,University Of Wisconsin - Milwaukee,16925665,28243310,50220000,95388975,263000000
OK,University Of Oklahoma,17935530,27880322,49305000,95120852,1736000000
OR,Portland Community College,12538743,29787645,52676000,95002388,0
NY,Cuny Bernard M. Baruch College,16563226,28496963,49783000,94843189,220000000
MD,Towson University,17335851,27802351,48800000,93938202,83500000
NM,New Mexico State University,14076359,27692217,51955000,93723576,182676000
MS,Mississippi State University,17856107,27549415,48318000,93723522,528679000
PR,University Of Puerto Rico - Rio Piedras Campus,16873620,27909114,48778000,93560734,127000000
FL,St. Petersburg College,12813482,29077189,50850000,92740671,57400000
KY,University Of Kentucky,17811058,26729420,47204000,91744478,1407221000
OH,Columbus State Community College,12562800,28667248,50509000,91739048,0
CA,Bakersfield College,12182994,28817459,50541000,91541453,0
NY,Cuny John Jay College Of Criminal Justice,15320009,27635844,48174000,91129853,0
TN,University of Memphis,15603749,27375611,47862000,90841360,220800000
NY,City College Of New York - Cuny,15399906,27101618,47252000,89753524,264000000
OR,Oregon State University,15559998,26602486,46974000,89136484,622473000
NY,Cuny Laguardia Community College,12917232,27737337,48436000,89090569,6200000
OK,Oklahoma State University,16765725,26166701,46027000,88959426,0
CA,"California State University, San Marcos",15963036,26602684,46376000,88941720,27900000
VA,Old Dominion University,15548901,26643627,46649000,88841528,261711000
NC,University Of North Carolina at Chapel Hill,17295177,25474540,45165000,87934717,3671351000
CA,East Los Angeles College,10797043,27863000,49235000,87895043,0
PR,Universidad Ana G. Méndez - Carolina Campus,14212207,25568181,47479000,87259388,0
CO,Metropolitan State University Of Denver,14390083,26366088,46146000,86902171,0
IA,University Of Iowa,16171354,24985012,44971000,86127366,1578933000
CA,Chaffey Community College,11446484,27096162,47539000,86081646,0
NY,State University Of New York At Albany,16063982,25189865,44087000,85340847,77700000
IL,Illinois State University,16121422,24967651,43834000,84923073,144435000
CA,Fresno City College,11224898,26689998,46894000,84808896,0
VA,Tidewater Community College,11999956,26394906,46174000,84568862,0
MO,University Of Missouri,16309144,24612553,43572000,84493697,1743142000
NY,Cuny Lehman College,13293096,25866919,45102000,84262015,0
MI,Western Michigan University,15486304,24878439,43702000,84066743,404653000
NY,Suffolk County Community College,13179539,25567624,44966000,83713163,0
CA,Cerritos Community College,12186449,25937610,45394000,83518059,0
CA,American River College,10613663,26247243,46362000,83222906,0
OR,University Of Oregon,16095946,24150869,42587000,82833815,912000000
LA,Delgado Community College,11310381,26068215,45345000,82723596,0
NC,Appalachian State University,15927932,24036104,42174000,82138036,122400000
NE,University Of Nebraska,15628700,23871084,42162000,81661784,1435753000
AR,University Of Arkansas,15454361,23908298,42289000,81651659,1221935000
CA,"California State University, East Bay",14617347,24243652,42317000,81177999,0
CA,El Camino College,11659979,25121457,44176000,80957436,0
CA,Santa Monica College,12193513,24643186,43542000,80378699,0
IL,Northern Illinois University,14825179,23728409,41518000,80071588,80065000
MA,Boston University,14995316,23192730,41556000,79744046,2304235000
MS,University Of Mississippi,16642638,22812460,40263000,79718098,736288000
GA,Georgia Gwinnett College,13470330,24155260,42048000,79673590,0
AL,Auburn University,15645745,23036339,40966000,79648084,792983000
GA,University Of North Georgia,13636481,23881394,41865000,79382875,55600000
KS,Kansas University,15189645,23072146,40884000,79145791,1816931000
CA,Riverside City College,10831532,24611165,43151000,78593697,0
MO,Missouri State University,13855674,23441360,41239000,78536034,145800000
NJ,Rowan University,14471695,23165569,40676000,78313264,232094000
UT,Weber State University,11714226,24098981,42489000,78302207,150522000
MI,Eastern Michigan University,13733990,23256060,40832000,77822050,78171000
IN,Ball State University,15246930,22465635,39765000,77477565,212834000
UT,Salt Lake Community College,10647873,24130769,42580000,77358642,0
OH,University Of Akron,14151817,22879071,40198000,77228888,235962000
IL,Depaul University,14373219,22684440,39976000,77033659,696452000
TX,Collin County Community College,10790912,23826101,42319000,76936013,0
MI,Central Michigan University,14322194,22642806,39780000,76745000,189322000
NC,North Carolina Agricultural & Technical State University,14103628,22848969,39774000,76726597,73800000
NY,Queensborough Community College-Cuny,11321080,23701583,41362000,76384663,0
NJ,Kean University,13509139,22855391,39893000,76257530,0
NV,"University Of Nevada , Reno",14244534,22437606,39517000,76199140,367500000
CA,"California State University, Bakersfield",13588942,22855632,39754000,76198574,25474000
MI,Oakland University,13796824,22347727,39264000,75408551,99399000
TX,San Jacinto Community College District,8950463,23826057,42022000,74798520,0
MD,Montgomery College,10995749,23080761,40556000,74632510,0
PA,Drexel University,13179268,21945057,39438000,74562325,813685000
NY,College Of Staten Island/Cuny,12595956,22565946,39350000,74511902,0
OH,Cuyahoga Community College,10027370,23257012,40795000,74079382,0
CA,"California State University, Stanislaus",13314715,22007207,38261000,73582922,0
RI,Johnson & Wales University,14182680,21525278,37558000,73265958,0
TX,Prairie View Agricultural & Mechanical University,13752928,21681605,37676000,73110533,0
OH,University Of Toledo,13547254,21572302,37917000,73036556,454114000
TX,Remington College,13408868,21585012,37725000,72718880,0
MS,University Of Southern Mississippi,13506042,21475374,37492000,72473416,104878000
AZ,Pima County Community College,9989049,22597292,39694000,72280341,0
NY,Nassau Community College,12022119,21854649,38330000,72206768,0
NC,Central Piedmont Community College,10787553,22154356,38852000,71793909,33276000
CA,California Polytechnic State University,14095976,20752799,36681000,71529775,227700000
OH,Bowling Green State University,13163417,21124710,37162000,71450127,149438000
MA,University Of Massachusetts - Boston,12184652,21381281,37440000,71005933,0
NY,Kingsborough Commmunity College/Cuny,10156521,22157742,38688000,71002263,0
NC,Wake Technical Community College,10390849,21750983,38154000,70295832,0
RI,Community College Of Rhode Island,10000569,21958065,38309000,70267634,0
FL,Florida Agricultural & Mechanical University,13051325,20845563,36273000,70169888,95600000
PR,Pontifical Catholic University Of Puerto Rico (The),12669949,20974546,36417000,70061495,0
SC,Clemson University,13579995,20323247,36093000,69996242,774514000
NY,Binghamton University,13607332,20273531,35679000,69559863,0
CA,Antelope Valley College,10245691,21580696,37647000,69473387,0
LA,University Of Louisiana At Lafayette,12686007,20614028,36119000,69419035,153000000
NY,Cuny Bronx Community College,9658626,21655807,37641000,68955433,0
KY,University Of Louisville,12478790,20434285,36008000,68921075,719816000
OH,Miami University,12989033,19996909,35489000,68474942,560965000
NM,Central New Mexico Community College,9305433,21404465,37661000,68370898,0
CA,"University Of California, Merced",13037897,20217509,35115000,68370406,0
TX,Texas State Technical College,9965155,21292313,37108000,68365468,0
MD,Community College Of Baltimore County,9349870,21419784,37525000,68294654,0
OH,Cleveland State University,12226765,20280093,35553000,68059858,0
ID,Boise State University,10937516,20644600,36458000,68040116,115056000
AL,University Of Alabama At Birmingham,12131256,20190148,35527000,67848404,537300000
NY,Saint John'S University,12191880,20127659,35491000,67810539,208738000
PA,Harrisburg Area Community College,9105781,21319018,37300000,67724799,0
KS,Kansas State University,12686554,19845018,35036000,67567572,510300000
TX,Blinn College,14141911,19342202,33875000,67359113,0
MI,Macomb Community College,9617297,20872067,36647000,67136364,0
FL,University Of North Florida,11770196,20011442,35124000,66905638,116186000
CA,Modesto Junior College,9575504,20615809,36120000,66311313,0
IL,College Of Du Page,9100886,20581172,36504000,66186058,0
CA,Fullerton College,9700734,20180789,35604000,65485523,0
WI,Milwaukee Area Technical College,8505373,20700673,36160000,65366046,0
TX,Texas Southern University,11796898,19514520,33957000,65268418,59400000
MS,Hinds Community College,10520779,19910506,34710000,65141285,0
CA,Mt. San Jacinto College,9713109,20043399,35128000,64884508,0
NY,Cornell University,12800980,18512730,33049000,64362710,7328241000
OK,University Of Central Oklahoma,11170390,19306609,33801000,64277999,0
MA,Northeastern University,11648813,18744880,33705000,64098693,1055474000
NY,Columbia University In The City Of New York,12830199,18314873,32952000,64097072,10950738000
NY,Monroe Community College,9166962,19927127,34921000,64015089,0
FL,Indian River State College,9553094,19691247,34501000,63745341,0
CA,Southwestern Community College District,9253264,19762638,34712000,63727902,0
CO,University Of Colorado Denver,10184083,19226923,34108000,63519006,593000000
PA,West Chester University Of Pennsylvania,11992115,18645808,32820000,63457923,0
MO,Saint Louis Community College,8727263,19785083,34748000,63260346,0
LA,Southeastern Louisiana University,10580284,18997836,33266000,62844120,0
CA,Glendale Community College,10056959,19042328,33367000,62466287,0
KY,Western Kentucky University,10636493,18748413,32954000,62338906,175186000
FL,Florida Gulf Coast University,11143620,18572907,32567000,62283527,84600000
DE,University Of Delaware,12174809,18010638,32080000,62265447,1466070000
MI,Henry Ford College,9153117,19312149,33712000,62177266,0
FL,Florida Southwestern State College,9178997,19237570,33689000,62105567,0
CA,Sacramento City College,7946038,19563511,34491000,62000549,0
GA,University Of West Georgia,10881459,18585785,32491000,61958244,0
WA,Western Washington University,11641693,18228534,31969000,61839227,77349000
VA,James Madison University,12080658,17880192,31758000,61718850,111065000
AL,University Of South Alabama,11408535,18170202,31876000,61454737,383512000
DE,Delaware Technical Community College,9008399,19085686,33348000,61442085,0
KY,Eastern Kentucky University,10542767,18411187,32230000,61183954,69139000
AZ,Glendale Community College,8301836,19156542,33641000,61099378,0
TX,Tarleton State University,10893519,18126764,31698000,60718283,0
MO,Metropolitan Community College,8709049,18839455,33027000,60575504,0
TN,East Tennessee State University,11096758,17943833,31435000,60475591,127684000
NE,University Of Nebraska At Omaha,10759273,18001689,31576000,60336962,71600000
TN,Austin Peay State University,9687866,18455648,32177000,60320514,0
HI,University Of Hawaii At Manoa,11009867,17701585,31212000,59923452,327000000
RI,University Of Rhode Island,11238683,17440405,30786000,59465088,149154000
TX,University Of Houston - Downtown,9456650,18182989,31758000,59397639,0
FL,Eastern Florida State College,8816361,18346823,32087000,59250184,0
CA,Orange Coast College,9120468,18102486,31971000,59193954,0
NH,University Of New Hampshire,11647555,17118551,30232000,58998106,803867000
VA,University Of Virginia,11716710,16866806,30229000,58812516,7058235000
OK,Tulsa Community College,7980293,18390355,32212000,58582648,0
OH,Youngstown State University,10376462,17353182,30357000,58086644,279778000
OH,Wright State University,10140846,17372092,30558000,58070938,97080000
NY,Suny College At Buffalo,10484417,17271471,30077000,57832888,0
NY,Syracuse University,9920122,17139335,30741000,57800457,1392691000
OH,Sinclair Community College,7434204,18192393,32046000,57672597,30718000
TX,Stephen F Austin State University,10525078,17133422,29973000,57631500,0
FL,Seminole State College Of Florida,8150059,17960733,31497000,57607792,0
MA,Bunker Hill Community College,8310307,17939271,31347000,57596578,0
NY,Rochester Institute Of Technology,10380480,17026233,29972000,57378713,944883000
NC,University Of North At Carolina Wilmington (The),10566053,16948600,29804000,57318653,104000000
CA,College Of The Sequoias,8630859,17686139,30894000,57210998,0
TX,San Antonio College,7648254,17950364,31537000,57135618,0
PA,Community College Of Allegheny County,7987479,17789944,31264000,57041423,0
AZ,Mesa Community College,7352103,17795363,31352000,56499466,0
GA,Georgia Institute Of Technology,10388077,16463107,29480000,56331184,2169005000
WA,Eastern Washington University,9986299,16721122,29327000,56034421,24195000
TX,Texas A&M International University,9501756,16965643,29504000,55971399,0
TX,Texas A&M University - Corpus Christi,10105662,16650317,29147000,55902979,0
MT,Montana State University,10560079,16378060,28909000,55847139,180168000
CA,Victor Valley Community College,8067843,17276235,30171000,55515078,0
NJ,Hudson County Community College,8467661,17156604,29847000,55471265,0
CA,Los Angeles Pierce College,7694796,17269929,30374000,55338725,0
CA,Palomar College,7702862,17131625,30395000,55229487,0
MO,Ozarks Technical Community College,7950662,17034808,29731000,54716470,0
NJ,William Paterson University Of New Jersey,9763356,16326775,28497000,54587131,0
CA,Humboldt State University,10302998,16130016,28056000,54489014,30294000
NJ,Bergen Community College,8461418,16666659,29228000,54356077,0
TX,Baylor University,10777489,15704656,27828000,54310145,1340417000
CA,San Joaquin Delta College,7835430,16847806,29616000,54299236,0
IA,Des Moines Area Community College,7345999,16915417,30001000,54262416,0
IN,Indiana State University,9566914,16123384,28215000,53905298,67714000
MI,Ferris State University,9146813,16169673,28320000,53636486,87355000
MD,University Of Maryland Global Campus,5210563,17500109,30845000,53555672,0
AL,Troy University,8544084,16265960,28482000,53292044,129192000
IL,Loyola University,10043948,15534548,27467000,53045496,692166000
GA,Valdosta State University,9331398,15904262,27784000,53019660,0
NE,Metropolitan Community College,5767395,14067027,24786000,44620422,0
CA,Sierra College,7595581,16340166,28802000,52737747,0
NJ,Stockton University,10041238,15511416,27132000,52684654,0
MI,Oakland Community College,7474366,16298327,28758000,52530693,0
SC,Coastal Carolina University,10054347,15415915,26975000,52445262,51483000
IL,Southern Illinois University Edwardsville,9678393,15509840,27230000,52418233,26568000
CO,Pikes Peak Community College,7543778,16312451,28549000,52405229,0
FL,Daytona State College,7681731,16243172,28420000,52344903,0
PA,Indiana University Of Pennsylvania,10050461,15342227,26877000,52269688,7615000
CA,City College Of San Francisco,7009874,16223115,28984000,52216989,0
AR,Arkansas State University,9258158,15575949,27357000,52191107,84430000
AR,University Of Central Arkansas,9604924,15456600,27055000,52116524,0
TN,Tennessee State University,7214661,13306383,31435000,51956044,127684000
LA,Southern University And Agricultural & Mechanical Colg At Baton Rouge,9396803,15459340,26887000,51743143,0
MA,University Of Massachusetts - Lowell,8900322,15481101,27285000,51666423,100000000
CA,Rio Hondo Community College,6232775,16317598,28860000,51410373,0
NC,Guilford Technical Community College,8260390,15718356,27393000,51371746,0
CO,Front Range Community College,7046470,16023686,28248000,51318156,0
MI,Wayne County Community College District,6158090,16399714,28688000,51245804,0
MD,University Maryland,9315657,15200168,26720000,51235825,232473000
NY,"Cuny, Hostos Community College",7267430,16037693,27864000,51169123,0
TN,University Of Tennessee - Chattanooga,9513779,15131381,26509000,51154160,0
PA,University Of Pennsylvania,9907683,14600409,26364000,50872092,14649762000
TN,Southwest Tennessee Community College,7298437,15887215,27671000,50856652,0
CA,Grossmont College,7141562,15800280,27833000,50774842,0
TX,Texas Woman'S University,8683388,15250810,26807000,50741198,79577000
FL,Tallahassee Community College,7763584,15548981,27210000,50522565,0
FL,Santa Fe College,7859449,15471315,27163000,50493764,0
CA,Santa Ana College,5594396,16096029,28797000,50487425,0
CA,Cypress College,7147934,15639532,27506000,50293466,0
TX,Laredo College,8926222,15039999,26316000,50282221,0
KS,Wichita State University,8786465,14991432,26317000,50094897,276142000
CT,Central Connecticut State University,9009014,14879577,26085000,49973591,0
CA,Imperial Valley College,4995150,16249873,28275000,49520023,0
TX,Northwest Vista College,6926619,15424223,27149000,49499842,0
WV,Marshall University,9003939,14679980,25792000,49475919,140181000
MN,"Minnesota State University, Mankato",9088962,14617272,25760000,49466234,0
NC,Western Carolina University,8893407,14719306,25761000,49373713,88701000
AL,Alabama Agricultural & Mechanical University,9121201,14519790,25215000,48855991,0
TX,Tyler Junior College,7395647,15043429,26340000,48779076,0
NJ,Middlesex County College,7378634,14976713,26245000,48600347,0
MS,Mississippi Gulf Coast Community College,7880280,14832095,25873000,48585375,0
SC,Midlands Technical College,7332783,15009166,26197000,48538949,9289000
NJ,Essex County College,7752662,14868024,25891000,48511686,0
MA,Bridgewater State University,8833662,14374448,25299000,48507110,0
MD,Morgan State University,9263592,14278129,24877000,48418721,0
NC,North Carolina Central University,8932233,14295567,24908000,48135800,0
MA,Harvard University,8655748,13992069,25453000,48100817,39427896000
NY,Suny Westchester Community College,7195672,14856758,25985000,48037430,0
NY,Erie Community College,7995845,14464959,25390000,47850804,0
NJ,Union County College,7393008,14722903,25706000,47821911,0
CA,Citrus College,7429415,14643671,25731000,47804086,0
CA,California State University Channel Islands,8580009,14288099,24872000,47740108,16050000
DC,George Washington University,9118529,13793324,24768000,47679853,1778559000
PR,Inter American University Of Puerto Rico - Bayamon Campus,8889905,14186459,24560000,47636364,0
CA,Sonoma State University,9093447,13980795,24453000,47527242,52281000
VA,Radford University,9092203,14055735,24359000,47506938,56080000
MI,Grand Rapids Community College,6806171,14722172,25851000,47379343,0
NJ,New Jersey City University,8337070,14225979,24790000,47353049,0
CA,Los Angeles Valley College,6154624,14883877,26161000,47199501,0
CO,University Of Colorado Colorado Springs,7925645,14140787,24876000,46942432,0
CA,College Of The Desert,7061346,14500076,25357000,46918422,0
MD,Prince George'S Community College,6421788,14714347,25763000,46899135,0
IL,Southern Illinois University At Carbondale,8866635,13756851,24136000,46759486,0
CA,De Anza Community College,7235258,14159017,25192000,46586275,0
FL,Embry-Riddle Aeronautical University,6845716,14390767,25327000,46563483,161405000
CA,College Of The Canyons,6326734,14427200,25722000,46475934,0
IL,Moraine Valley Community College,6465543,14452872,25493000,46411415,0
CA,Butte College,7281962,14144568,24730000,46156530,0
NJ,New Jersey Institute Of Technology,8110969,13798201,24200000,46109170,129455000
CA,San Bernardino Valley College,6732563,14257809,25044000,46034372,0
PR,Inter American University Of Puerto Rico San Germán Campus,8830671,13593393,23554000,45978064,0
TN,Tennessee Technological University,8713463,13533046,23687000,45933509,0
KY,Northern Kentucky University,7998963,13713911,24131000,45843874,105501000
CT,Southern Connecticut State University,8390168,13594612,23804000,45788780,30520000
MS,Jackson State University,8446248,13577858,23631000,45655106,0
PR,Inter American University Of Puerto Rico - Metropolitan Campus,7548666,13899227,24198000,45645893,0
NY,Cuny York College,7205414,14007349,24431000,45643763,0
MN,St. Cloud State University,7821764,13652272,24024000,45498036,0
CA,Diablo Valley College,6679277,13947135,24804000,45430412,0
CA,"California State University, Monterey Bay",8459727,13455716,23461000,45376443,0
CA,California Baptist University,7913118,13577444,23756000,45246562,65618000
FL,Pasco - Hernando State College,6574907,13965491,24418000,44958398,0
WI,University Of Wisconsin - Whitewater,8169773,12907818,23878000,44955591,0
LA,Baton Rouge Community College,6420025,14020032,24419000,44859057,0
WA,Central Washington University,7695384,13588432,23572000,44855816,0
CA,San Diego Mesa College,5911519,13992119,24888000,44791638,0
CA,Merced Community College,6536491,13763999,24120000,44420490,0
NY,Cuny Medgar Evers College,7109437,13615664,23689000,44414101,0
SC,Greenville Technical College,6663667,13723584,23994000,44381251,0
NY,Pace University,8562106,12938858,22868000,44368964,193049000
IL,Northwestern University,8521175,12775920,22993000,44290095,11091516000
SC,Trident Technical College,6568275,13700146,24010000,44278421,0
IA,Kirkwood Community College,6336610,13718324,24116000,44170934,0
GA,Savannah College Of Art And Design,8209651,12972158,22938000,44119809,0
DC,Howard University,8723244,12747281,22324000,43794525,692832000
PR,Inter American University Of Puerto Rico - Aguadilla Campus,8125496,12904606,22341000,43371102,0
CA,Los Angeles Trade-Technical College,5124229,13850786,24378000,43353015,0
IN,Purdue University Global,816781,15423168,27103000,43342949,0
IL,Western Illinois University,7997093,12857820,22455000,43309913,0
ID,Idaho State University,7097839,13094512,23001000,43193351,0
CA,Cosumnes River College,5574947,13570233,23910000,43055180,0
FL,Polk State College,6116050,13292541,23258000,42666591,0
NY,Suny College At Oswego,7244716,12886557,22508000,42639273,0
TX,Lamar University,7048774,12878096,22641000,42567870,26222000
MO,University Of Missouri - Kansas City,7062723,12791149,22638000,42491872,0
CO,University Of Northern Colorado,7650214,12601749,22205000,42456963,89775000
NC,Fayetteville Technical Community College,5913774,13276771,23217000,42407545,0
CA,Santa Rosa Junior College,5942841,13114035,23333000,42389876,0
AR,Arkansas Tech University,7098986,12806406,22408000,42313392,0
NY,Touro College,7558879,12565306,22146000,42270185,0
TX,Texas A&M University - Commerce,7193156,12743661,22316000,42252817,0
NY,Mercy College,7046720,12742981,22286000,42075701,255751000
NY,Suny College At Brockport,7750148,12461885,21778000,41990033,0
MT,University Of Montana (The),7652275,12405952,21796000,41854227,0
NY,Fordham University,8147184,12071949,21532000,41751133,733516000
ME,University Of Maine,7603694,12814741,21233000,41651435,227085000
CA,Los Angeles City College,5197272,13476393,22846000,41519665,0
PA,Northampton County Area Community College,6039116,12847473,22454000,41340589,57014000
PA,Bloomsburg University Of Pennsylvania,7906785,12137403,21259000,41303188,0
CA,Miracosta College,5511006,12933970,22777000,41221976,0
PR,Inter American University Of Puerto Rico - Ponce Campus,7526308,12302765,21324000,41153073,0
FL,University Of Miami,8139089,11829536,21171000,41139625,0
NY,State University Of New York At Farmingdale,6154318,12645901,22339000,41139219,0
NJ,Camden County College,5784112,12826935,22495000,41106047,0
NJ,Brookdale Community College,6334411,12582654,22163000,41080065,0
LA,Grambling State University,7010388,12427854,21600000,41038242,0
GA,Georgia Military College,5998679,12723116,22285000,41006795,0
IA,University Of Northern Iowa,7618737,12078044,21259000,40955781,129019000
NY,Long Island University,7007826,12239114,21670000,40916940,238973000
FL,University Of West Florida (The),6801388,12369966,21717000,40888354,0
FL,Pensacola State College,6004939,12679127,22177000,40861066,0
RI,Rhode Island College,7443916,12110287,21159000,40713203,0
ND,North Dakota State University - Fargo,7728326,11906777,21024000,40659103,0
TX,Texas A&M University - Kingsville,7087427,12173235,21281000,40541662,0
OR,Chemeketa Community College,5750738,12612572,22114000,40477310,0
SC,College Of Charleston,7642022,11866554,20905000,40413576,100136000
CO,Colorado Mesa University,7068379,12116155,21213000,40397534,34875000
IL,Harper College,5526516,12582067,22281000,40389583,25382000
KY,Jefferson Community And Technical College,5179693,12800342,22392000,40372035,0
MI,University Of Michigan - Dearborn,6989129,12130348,21231000,40350477,0
MO,University Of Central Missouri,6908319,12074346,21271000,40253665,0
WI,Madison Area Technical College,5500069,12510691,22095000,40105760,0
NJ,Rowan College Of South Jersey,6557641,12793980,20637000,39988621,0
WI,University Of Wisconsin - Oshkosh,6207761,11441915,22157000,39806676,0
PA,Delaware County Community College,5360154,12387247,22039000,39786401,0
OK,Oklahoma City Community College,5566700,12328985,21760000,39655685,0
MO,University Of Missouri - Saint Louis,5830225,12190644,21566000,39586869,0
IL,Joliet Junior College,5497625,12291882,21773000,39562507,0
UT,Dixie State University,6176699,12124489,21246000,39547188,0
ID,University Of Idaho,6905295,11786287,20753000,39444582,291868000
GA,Gwinnett Technical College,5336576,12417270,21682000,39435846,0
GA,Emory University,7974341,11277994,20158000,39410335,7872381000
TX,Central Texas College District,4544176,12611938,22185000,39341114,0
FL,Nova Southeastern University,7157194,11510184,20494000,39161378,0
PA,Kutztown University Of Pennsylvania,7424966,11533902,20190000,39148868,0
PR,University Of Puerto Rico - Arecibo,7684735,11195711,19382000,38262446,0
PR,Inter American University Of Puerto Rico - Arecibo Campus,7100104,11633980,20153000,38887084,0
LA,Louisiana Tech University,7094887,11558542,20121000,38774429,0
OH,Stark State College,5036299,12228524,21385000,38649823,0
MO,Southeast Missouri State University,6830214,11510345,20198000,38538559,0
PA,Slippery Rock University,7354069,11285058,19805000,38444127,0
CA,Santa Barbara City College,5767428,11790275,20856000,38413703,0
MN,University Of Minnesota Duluth,7453951,11174098,19706000,38334049,0
VA,Norfolk State University,6901715,11451132,19898000,38250847,24435000
MI,Saginaw Valley State University,6911064,11372114,19912000,38195178,87436000
WI,University Of Wisconsin - Eau Claire,7091955,11056971,19990000,38138926,81094000
GA,Clayton State University,6165671,11647843,20280000,38093514,0
CA,Stanford University,7376668,10890455,19630000,37897123,27699834000
KS,Johnson County Community College,5080285,11797233,21010000,37887518,0
MI,Washtenaw Community College,4968890,11902486,20985000,37856376,0
NJ,Passaic County Community College,5451658,11803091,20591000,37845749,0
IL,Harold Washington College,5708949,11637196,20372000,37718145,0
MI,Lansing Community College,5804315,11559366,20306000,37669681,0
AK,University Of Alaska Anchorage,5445184,11625475,20584000,37654659,0
PR,University Of Puerto Rico Bayamon Technical University College,6991670,11082944,19567000,37641614,0
NY,Fashion Institute Of Technology,7035399,11106697,19490000,37632096,0
CA,San Diego City College,4592301,11923790,21094000,37610091,0
UT,Stevens Henager College,2830028,11895706,22811000,37536734,0
GA,Middle Georgia State University,5988167,11474878,20012000,37475045,0
MI,Baker College,5754381,11529356,20091000,37374737,0
UT,Southern Utah University,5624696,11460963,20173000,37258659,0
GA,Columbus State University,6352178,11232074,19633000,37217252,69502000
AZ,Phoenix College,4772192,11740227,20595000,37107419,0
GA,Albany State University,5137088,11661954,20281000,37080042,0
IL,College Of Lake County,4973042,11539049,20458000,36970091,0
MI,Charles Stewart Mott Community College,5378749,11499149,20052000,36929898,0
CA,University Of San Francisco,7293888,10701243,18909000,36904131,399571000
TX,Angelo State University,6359561,11037672,19375000,36772233,0
IL,Northeastern Illinois University,6070904,11170485,19527000,36768389,0
NC,University Of North Carolina At Pembroke,6274710,11102045,19354000,36730755,24886000
VT,University Of Vermont And State Agricultural College,7055880,10675412,18995000,36726292,0
GA,Central Georgia Technical College,5100288,11496965,20061000,36658253,0
KY,Morehead State University,6016440,11119678,19479000,36615118,0
MO,Lindenwood University,6706309,10755236,18921000,36382545,0
TN,Chattanooga State Community College,5283482,11325214,19762000,36370696,0
NY,State University Of New York At New Paltz,6537407,10821964,18954000,36313371,0
AR,University Of Arkansas At Little Rock,5956500,11008760,19287000,36252260,0
MD,Bowie State University,6596246,10788569,18806000,36190815,0
VA,Virginia State University,6855810,10694110,18639000,36188920,57383000
OH,Lorain County Community College,4917956,11339576,19872000,36129532,40485000
LA,South Louisiana Community College,5645949,11077607,19326000,36049556,0
MA,Salem State University,6512818,10710632,18782000,36005450,49755000
FL,Bethune Cookman University,6648501,10731233,18601000,35980734,0
LA,Northwestern State University,5647034,11025862,19278000,35950896,0
NY,Onondaga Community College,5222555,11118319,19484000,35824874,0
GA,Chattahoochee Technical College,4903653,11215138,19677000,35795791,0
WY,University Of Wyoming,6613580,10546335,18627000,35786915,515121000
TX,Texas A&M University-San Antonio,5613425,10982357,19141000,35736782,0
AZ,Estrella Mountain Community College,4856585,11191621,19610000,35658206,0
MS,Northwest Mississippi Community College,5787016,10861070,18998000,35646086,0
FL,University Of Tampa (The),6941444,10370376,18283000,35594820,0
TN,Pellissippi State Community College,5171189,10977362,19281000,35429551,11604000
FL,Ultimate Medical Academy,469150,12230799,22713000,35412949,0
NC,Pitt Community College,5510793,10858478,18997000,35366271,0
WI,University Of Wisconsin - Lacrosse,6789642,10311865,18212000,35313507,0
KY,Bluegrass Community & Technical College,4961119,11036893,19303000,35301012,0
MA,University Of Massachusetts - Dartmouth,6288232,10476776,18352000,35117008,0
IN,Purdue University Northwest,5824998,10594351,18589000,35008349,0
NC,Forsyth Technical Community College,4933805,9807067,20195000,34935872,0
TX,Mclennan Community College,4898030,10915188,19117000,34930218,0
WI,University Of Wisconsin - Stevens Point,6312792,9947577,18504000,34764369,0
IN,Purdue University Fort Wayne,5589305,10558946,18545000,34693251,0
SC,University Of South Carolina Upstate,6104655,10394456,18124000,34623111,0
PA,East Stroudsburg University Of Pennsylvania,6469323,10246794,17903000,34619117,0
MN,Century College,4996271,10765178,18844000,34605449,0
TX,Amarillo College,4794394,10841767,18938000,34574161,0
KY,Murray State University,6270769,10236265,17965000,34472034,89480000
MI,Delta College,5146606,10658617,18631000,34436223,25581000
CA,Moorpark College,5143560,10545381,18699000,34387941,0
FL,"State College Of Florida, Manatee-Sarasota",5023266,10660667,18697000,34380933,0
LA,University Of Louisiana At Monroe,5777764,10393276,18208000,34379040,0
AL,Jacksonville State University,6050640,10296298,18020000,34366938,0
NC,Winston-Salem State University,6117980,10294709,17902000,34314689,49755000
FL,Southeastern University,4820567,8993865,15788000,29602432,0
MN,Metropolitan State University,5159002,10533046,18397000,34089048,6017000
NY,Hudson Valley Community College,5108581,10491761,18480000,34080342,0
GA,Savannah State University,6374932,10115570,17553000,34043502,0
IN,University Of Southern Indiana,5890282,10178801,17918000,33987083,0
AL,Alabama State University,6284463,10072950,17575000,33932413,0
OK,Northeastern State University,5676974,10255813,17916000,33848787,0
MO,Columbia College,4385319,10707484,18715000,33807803,168869000
IL,City Colleges Of Chicago - Malcolm X College,4919757,10502178,18381000,33802935,0
WA,Clark College,5205413,10339712,18170000,33715125,246794000
WI,Marquette University,6646735,9752321,17303000,33702056,698021000
SD,South Dakota State University,6020168,9990468,17669000,33679636,132678000
FL,Saint Leo University,4579587,10573988,18512000,33665575,0
TX,University Of Houston - Clear Lake,5555369,10205153,17892000,33652522,0
MN,Normandale Community College,4802575,10454594,18376000,33633169,0
TX,West Texas A&M University,5764767,10101563,17714000,33580330,0
MA,Boston College,6448576,9728036,17397000,33573612,2523300000
MA,Quinsigamond Community College,4828361,10469338,18267000,33564699,0
CT,Yale University,6851139,9389616,17320000,33560755,30314800000
ID,College Of Western Idaho,4030648,10671497,18852000,33554145,0
GA,Augusta University,6145342,9937667,17469000,33552009,0
IN,Vincennes University,4866528,10327711,18333000,33527239,0
NC,Duke University,6714022,9388487,17421000,33523509,8609004000
IL,Wilbur Wright College,5035279,10302824,18170000,33508103,0
FL,College Of Central Florida,5063707,10354340,18073000,33491047,72029000
NJ,Fairleigh Dickinson University,5771203,10026608,17685000,33482811,91625000
CA,Ventura College,4581538,10430052,18419000,33430590,0
MI,Schoolcraft College,4676826,10389325,18273000,33339151,0
CA,Reedley College,4243892,10534587,18560000,33338479,0
SC,Horry - Georgetown Technical College,5158587,10253428,17878000,33290015,0
IL,Columbia College Chicago,6341542,9790759,17135000,33267301,0
CT,Naugatuck Valley Community College,3819528,8536320,20873000,33228848,0
MI,Northern Michigan University,5994618,9891128,17337000,33222746,15400000
IL,Southwestern Illinois College,4677515,10331215,18191000,33199730,0
MN,Minneapolis Community And Technical College,4640122,10358338,18086000,33084460,0
TN,Nashville State Community College,4689355,10323371,18051000,33063726,0
TX,Del Mar College,3854029,10600037,18596000,33050066,0
LA,University Of New Orleans (The),5581887,9972376,17484000,33038263,0
MD,Johns Hopkins University,6266940,9496212,17260000,33023152,6275939000
TX,South Plains College,5182219,10118799,17691000,32992018,0
DC,American University (The),6314017,9543682,17070000,32927699,0
WI,Herzing University,4328833,10441249,18122000,32892082,0
NY,Suny College At Cortland,6245138,9642783,16892000,32779921,0
MD,Howard Community College,4800099,10064936,17703000,32568035,0
MN,Saint Paul College - A Community & Technical College,4580520,10171146,17756000,32507666,0
MO,Washington University In St. Louis,6368472,9322223,16806000,32496695,7953986000
MA,Bristol Community College,4686502,10097346,17629000,32412848,0
CA,University Of La Verne,5658977,9709997,17020000,32388974,111994000
AR,University Of Arkansas At Fort Smith,5511303,9777559,17053000,32341862,0
DC,Georgetown University,6110643,9301024,16800000,32211667,1822484000
MD,Salisbury University,5959457,9493680,16709000,32162137,56034000
PR,Universidad Politecnica De Puerto Rico,5734996,9627350,16750000,32112346,0
IL,Triton College,4211898,10068612,17778000,32058510,0
IL,Elgin Community College,4600718,9931520,17497000,32029238,6973000
NC,Cape Fear Community College,4726439,9895172,17347000,31968611,0
AL,Calhoun Community College,4392248,10001547,17570000,31963795,0
TN,Volunteer State Community College,4689090,9915202,17352000,31956292,0
CO,Community College Of Denver,4443177,9998358,17497000,31938535,0
GA,West Georgia Technical College,4442806,10007656,17473000,31923462,0
NY,Suny College At Old Westbury,5522673,9608491,16756000,31887164,0
GA,Clark Atlanta University,6064349,9435889,16384000,31884238,0
CA,Golden West College,4318142,9911380,17502000,31731522,0
TX,University Of Texas At Tyler,5194610,9592692,16870000,31657302,0
WA,Spokane Community College,4173204,9935519,17521000,31629723,0
IL,University Of Chicago (The),6207010,8988981,16299000,31494991,0
AZ,Chandler - Gilbert Community College,4350989,9757937,17329000,31437926,0
PR,Universidad Del Sagrado Corazón,5395359,9498506,16494000,31387865,0
IN,Indiana Wesleyan University,4543246,9731895,17082000,31357141,204472000
CT,Gateway Community College,4296723,9850045,17210000,31356768,0
CA,Saddleback College,4296103,9691596,17348000,31335699,0
NY,Hofstra University,6249515,9026013,16022000,31297528,622235000
NJ,Beth Medrash Govoha Of America,5899593,9210836,16175000,31285429,0
PA,Carnegie Mellon University,5735086,9045100,16300000,31080186,2542650000
MD,Anne Arundel Community College,4315345,9667547,17083000,31065892,0
LA,Bossier Parish Community College,3915911,9852065,17154000,30921976,0
PR,University Of Puerto Rico - Humacao University College,5664236,9236475,16010000,30910711,0
AZ,Arizona Western College,4528738,9589819,16774000,30892557,0
MS,Alcorn State University,5886916,9094866,15791000,30772782,0
PA,Montgomery County Community College,4090103,9628984,16971000,30690087,0
PA,Millersville University Of Pennsylvania,5617301,9089274,15962000,30668575,0
NC,Fayetteville State University,5084687,9308810,16228000,30621497,24341000
CA,Irvine Valley College,4485810,9394933,16692000,30572743,0
VA,J Sargeant Reynolds Community College,4151184,9595572,16821000,30567756,0
NY,Suny College At Oneonta,5740817,9003120,15766000,30509937,0
ND,University Of North Dakota,5491551,8980342,15956000,30427893,0
NJ,Seton Hall University,5749918,8857951,15734000,30341869,264514000
MI,Kalamazoo Valley Community College,4249299,9456126,16593000,30298425,17756000
CA,Chabot College,4156840,9409398,16689000,30255238,0
LA,Mcneese State University,5456361,8997322,15771000,30224683,0
MN,Winona State University,5696956,8890555,15629000,30216511,0
CA,National University,4563497,9227970,16422000,30213467,216382000
NY,University Of Rochester,6011698,8616921,15479000,30107619,2239720000
PR,University Of Puerto Rico - Cayey University College,5738057,8907729,15439000,30084786,0
PR,"University Of Puerto Rico, Aguadilla Regional College",5899782,8844300,15334000,30078082,0
CA,Azusa Pacific University,5548456,8848314,15610000,30006770,0
CA,Hartnell Community College,3615339,9501755,16836000,29953094,0
NE,Southeast Community College,4282436,9303287,16347000,29932723,0
AL,Coastal Alabama Community College,4437762,9254055,16218000,29909817,0
CA,Moreno Valley College,3681844,9460917,16674000,29816761,0
OH,Owens Community College,3937786,9317892,16429000,29684678,0
CA,Evergreen Valley College,3949985,9289992,16388000,29627977,0
OH,Cincinnati State Technical & Community College,4228115,9223681,16172000,29623796,0
TX,Texas Christian University,5728641,8566705,15238000,29533346,1708867000
NJ,Ocean County College,4265169,9137920,16095000,29498089,0
TN,Northeast State Community College,4488316,8967575,15643000,29098891,12483000
GA,Augusta Technical College,4386678,8997908,15656000,29040586,0
AL,University Of North Alabama,5002648,8666299,15192000,28860947,0
LA,Nicholls State University,5057520,8626311,15095000,28778831,0
TX,University Of The Incarnate Word,5219687,8535960,15010000,28765647,142071000
CA,Shasta College,3673274,9115270,15977000,28765544,0
DE,Delaware State University,5565920,8459446,14739000,28764366,0
PA,Shippensburg University Of Pennsylvania,5436200,8476435,14850000,28762635,0
WA,Pierce College,3925203,8964719,15800000,28689922,0
CA,San Diego Miramar College,3235898,9144193,16296000,28676091,0
CA,Cabrillo College,4027260,8885242,15729000,28641502,0
TN,University Of Tennessee - Martin,5110311,8551121,14953000,28614432,0
WI,Northeast Wisconsin Technical College,3736257,8993456,15845000,28574713,0
GA,Dalton State College,4768309,8679276,15116000,28563585,0
TX,Navarro College,4101645,8879685,15578000,28559330,0
AR,University Of Arkansas - Pulaski Technical College,4476116,9423959,14656000,28556075,0
CA,Allan Hancock College,3853901,8924491,15766000,28544392,0
SC,Winthrop University,5382130,8423174,14737000,28542304,57949000
PR,"University Of Puerto Rico, Ponce",5314251,8364340,14856000,28534591,0
TN,Vanderbilt University,5632423,8200868,14679000,28512291,6270877000
TX,North Central Texas College,3862598,8921316,15708000,28491914,0
AL,Auburn University Montgomery,5075473,8523023,14878000,28476496,0
LA,Tulane University,5590189,8175012,14674000,28439201,1429707000
NY,State University Of New York College At Plattsburgh,5258169,8423237,14725000,28406406,0
IN,University Of Notre Dame,5793244,7969565,14590000,28352809,11268365000
KS,Pittsburg State University,5318769,8353746,14657000,28329515,76528000
MO,Saint Louis University,5141085,8305153,14862000,28308238,1252678000
PA,Lehigh Carbon Community College,3873075,8853093,15507000,28233168,0
NY,Suny At Fredonia,5513590,8267340,14420000,28200930,0
NJ,Rowan College At Burlington County,3750316,8855454,15595000,28200770,0
ME,University Of Southern Maine,4616245,8534700,15016000,28166945,0
NY,Adelphi University,5246966,8279486,14638000,28164452,187211000
VA,Thomas Nelson Community College,3853969,8822513,15468000,28144482,0
PA,Pennsylvania College Of Technology,5341470,8301655,14480000,28123125,0
NY,Suny Broome Community College,4364871,8632801,15094000,28091672,0
CA,Chapman University,5505229,8137393,14448000,28090622,417705000
WA,Green River College,4763642,8421086,14866000,28050728,0
NY,Mohawk Valley Community College - Suny Office Of Community Colleges,4368811,8603935,15057000,28029746,0
GA,Mercer University,5265925,8211054,14489000,27965979,0
MO,Missouri Southern State University,4756273,8447302,14728000,27931575,0
AL,Jefferson State Community College,3729878,8768415,15424000,27922293,0
CA,Laney College,3313469,8854083,15664000,27831552,0
TX,Texas Southmost College,3608280,8774434,15365000,27747714,0
OR,Lane Community College,3014266,8943191,15732000,27689457,0
TX,Lee College,4057094,8567819,15048000,27672913,363026000
CO,Pueblo Community College,3638453,8728074,15283000,27649527,0
GA,Georgia Highlands College,4220236,8527676,14892000,27639912,0
MO,Missouri University Of Science And Technology,5205598,8118979,14310000,27634577,0
CA,Los Medanos College,3838971,8585259,15148000,27572230,0
GA,Southern Crescent Technical College,3912287,8586232,14946000,27444519,0
NJ,Atlantic Cape Community College,3960342,8555148,14917000,27432490,0
MS,Pearl River Community College,4385949,8368310,14586000,27340259,0
OH,Ashland University,3987716,8488692,14846000,27322408,0
NY,"New School, The",4996686,7998165,14252000,27246851,0
TX,Saint Philip'S College,3427506,8602242,15215000,27244748,0
FL,Barry University,5027398,8001386,14127000,27155784,45448000
WI,University Of Wisconsin - Stout,4952605,8039386,14150000,27141991,0
MI,University Of Michigan - Flint,4600155,8146874,14284000,27031029,0
PA,Duquesne University Of The Holy Spirit,5373970,7783815,13873000,27030785,488351000
NJ,Mercer County Community College,3851115,8358417,14679000,26888532,0
WI,University Of Wisconsin - Platteville,4792670,7652424,14419000,26864094,0
CA,Norco College,3523056,8421677,14892000,26836733,0
MS,Itawamba Community College,4419244,8115985,14154000,26689229,0
TX,Palo Alto College,3240943,8485780,14933000,26659723,0
OH,University Of Dayton,5197738,7694898,13766000,26658636,604176000
KS,Washburn University - Topeka,4500174,8024016,14117000,26641190,0
CT,Quinnipiac University,5345199,7632879,13616000,26594078,556604000
IN,University Of Indianapolis,4902143,7840045,13754000,26496188,109448000
MO,Northwest Missouri State University,4792789,7854065,13791000,26437854,0
AL,George C. Wallace State Community College,4064802,8136032,14196000,26396834,0
CA,Cuesta College,3527579,8257338,14604000,26388917,35196000
IL,Aurora University,4697683,7853760,13760000,26311443,0
MI,Jackson College,3892134,8114820,14126000,26132954,0
TX,Southwest Texas Junior College,3736958,8149245,14243000,26129203,0
IL,Illinois Central College,3704633,8110353,14290000,26104986,0
IL,Eastern Illinois University,4506779,7820433,13746000,26073212,84387000
VA,John Tyler Community College,3448784,8170985,14407000,26026769,3785000
SC,Tri-County Technical College,4246483,7917841,13859000,26023324,27343000
WA,Bellevue College,4145089,7839658,14024000,26008747,0
MA,Springfield Technical Community College,3845054,8068676,14068000,25981730,0
IN,Indiana University - South Bend,4500518,7768280,13567000,25835798,0
CA,University Of The Pacific,5164869,7452559,13153000,25770428,463313000
MN,University Of Saint Thomas,5005202,7468750,13293000,25766952,0
NY,Rensselaer Polytechnic Institute,4828782,7283082,13563000,25674864,739648000
GA,Atlanta Technical College,3869156,7962803,13836000,25667959,0
NY,Suny Empire State College,3411359,8060895,14170000,25642254,0
MS,Holmes Community College,3916962,7897652,13792000,25606614,0
TX,Midwestern State University,4413874,7678441,13427000,25519315,0
PR,University Of Puerto Rico Carolina Regional College,4491903,7670211,13309000,25471114,0
WA,Yakima Valley College,4041726,7803497,13600000,25445223,0
CO,Colorado State University-Pueblo,3959862,7745423,13722000,25427285,0
KS,Butler County Community College,3631932,7901125,13881000,25414057,0
MA,Suffolk University,4935367,7382175,13033000,25350542,256300000
MA,Middlesex Community College,3704343,7847872,13797000,25349215,0
NJ,College Of New Jersey (The),5028131,7299736,12995000,25322867,0
OR,Mount Hood Community College,3385658,7917862,14019000,25322520,0
NJ,Monmouth University,4935299,7371976,12954000,25261275,107085000
NJ,Raritan Valley Community College,3819720,7748750,13657000,25225470,0
CT,Housatonic Community College,3450869,7936666,13806000,25193535,0
NV,Truckee Meadows Community College,3347251,7834837,13868000,25050088,0
MA,Massachusetts Institute Of Technology,5045387,7130129,12812000,24987516,17569328000
WA,Columbia Basin College,3840410,7650276,13434000,24924686,0
CA,Yuba College,3748918,7652045,13399000,24799963,0
CA,Loyola Marymount University,4723135,7219025,12852000,24794160,0
MA,Massasoit Community College,3581373,7679157,13484000,24744530,0
PA,California University Of Pennsylvania,4312587,7410738,13000000,24723325,0
MN,Anoka-Ramsey Community College,3580976,7650597,13470000,24701573,0
GA,Southern Regional Technical College,3604073,7686039,13383000,24673112,0
MA,Worcester State University,4222833,7394799,13026000,24643632,0
CA,Oxnard College,3127211,7788765,13663000,24578976,0
AL,Gadsden State Community College,3756166,7581323,13220000,24557489,0
MA,Holyoke Community College,3685390,7592856,13239000,24517246,0
CO,University Of Denver,4626269,7105908,12734000,24466177,786425000
WA,Tacoma Community College,3835874,7472853,13127000,24435727,0
MA,Westfield State University,4512060,7216874,12670000,24398934,0
RI,Brown University,4842231,7008633,12533000,24383864,3976694000
TX,Kilgore College,3908886,7463341,12972000,24344227,0
AL,George C. Wallace Community College,3655757,7531363,13133000,24320120,0
IL,Waubonsee Community College,3198731,7586569,13494000,24279300,0
NY,State University Of New York College At Potsdam,4389510,7227985,12584000,24201495,0
MA,North Shore Community College,3446732,7520742,13151000,24118474,0
TN,Walters State Community College,3688117,7421588,12977000,24086705,0
NJ,Ramapo College Of New Jersey,4606705,7054659,12412000,24073364,21364000
WI,University Of Wisconsin - River Falls,4427466,7099284,12476000,24002750,0
CT,University Of New Haven,4642795,6999198,12336000,23977993,0
CT,Manchester Community College,3235201,7524805,13179000,23939006,0
CT,Western Connecticut State University,4256393,7148969,12533000,23938362,0
MI,Michigan Technological University,4605779,6991814,12339000,23936593,113645000
KY,Campbellsville University,3201468,7256937,13475000,23933405,0
AL,Lawson State Community College,3522022,7444227,12941000,23907249,0
CT,University Of Hartford,4467175,7020751,12399000,23886926,182812000
CT,Eastern Connecticut State University,4433725,7060353,12363000,23857078,0
NJ,County College Of Morris,3734038,7274185,12847000,23855223,0
CA,Los Angeles Mission College,2940483,7612456,13292000,23844939,0
WI,Gateway Technical College,2614556,7675437,13535000,23824993,0
MA,Mcphs University,4414483,6808137,12549000,23771620,0
OR,Western Oregon University,4281683,7059841,12351000,23692524,0
SC,Piedmont Technical College,3433957,7392118,12864000,23690075,0
GU,University Of Guam,4564698,6947461,12103000,23615159,0
NY,Dutchess Community College,3592574,7233073,12767000,23592647,0
NY,Suny College Of Technology At Alfred,4425878,6987691,12158000,23571569,0
CA,Fresno Pacific University,4121557,7068175,12326000,23515732,0
DE,Wilmington University,3126974,7042779,13320000,23489753,0
NC,Asheville Buncombe Technical Community College,3686607,7164686,12605000,23456293,0
MA,Tufts University,4765237,6655929,12009000,23430166,1867962000
NY,New York Institute Of Technology,4377210,6855681,12109000,23341891,0
IL,Parkland College,3275003,7257218,12781000,23313221,0
WI,Fox Valley Technical College,2598816,7452169,13245000,23295985,0
NY,Suny College At Geneseo,4552123,6782413,11955000,23289536,0
TN,Belmont University,4597337,6711670,11957000,23266007,252091000
IN,Indiana Institute Of Technology,3336999,7249335,12632000,23218334,137039000
SC,Benedict College,4372336,6899448,11946000,23217784,0
NY,Ithaca College,4583253,6732724,11889000,23204977,347335000
CA,Cuyamaca College,2918721,7329288,12907000,23155009,0
NY,Niagara County Community College,3598909,7096692,12359000,23054601,0
TX,Southern Methodist University,4598259,6580843,11850000,23029102,1663864000
PA,La Salle University,4277300,6800498,11944000,23021798,80311000
AZ,Rio Salado Community College,2531870,7331461,13123000,22986331,0
CO,Community College Of Aurora,3035626,7224037,12720000,22979663,0
GA,Georgia Northwestern Technical College,3182360,7197142,12564000,22943502,0
SC,Spartanburg Community College,3358632,7124748,12428000,22911380,0
MA,Fitchburg State University,3910925,6854502,12103000,22868427,0
GA,Fort Valley State University,4166439,6827893,11853000,22847332,0
AR,University Of Arkansas At Pine Bluff,4295429,6774295,11748000,22817724,0
NY,Rockland Community College,3626632,6947584,12234000,22808216,0
MA,Northern Essex Community College,3271644,7115735,12415000,22802379,0
CA,University Of San Diego,4426552,6592664,11746000,22765216,545552000
NY,Suny College At Purchase,4290517,6722248,11752000,22764765,0
WI,University Of Wisconsin - Green Bay,3504931,6769674,12470000,22744605,0
OH,Case Western Reserve University,4514183,6502716,11714000,22730899,1866500000
PA,Reading Area Community College,3184345,7099987,12365000,22649332,0
NY,United Talmudical Seminary,4482702,6631109,11501000,22614811,0
CA,Folsom Lake College,2957869,7090043,12555000,22602912,0
NC,Campbell University,4307900,6604314,11634000,22546214,0
CT,Sacred Heart University,4305177,6550955,11652000,22508132,177133000
WA,Everett Community College,3327536,6893997,12254000,22475533,0
MO,Park University,2805843,7132764,12514000,22452607,79527000
FL,Florida Institute Of Technology,3607645,6819739,12013000,22440384,87759000
TN,Roane State Community College,3314382,6955614,12163000,22432996,0
KY,Somerset Community College,3029445,7072505,12320000,22421950,0
SD,University Of South Dakota,3634766,6766389,11975000,22376155,244474000
AZ,Grand Canyon University,22351397,0,0,22351397,0
DC,University Of The District Of Columbia,3609526,6814702,11912000,22336228,0
NC,Catawba Valley Community College,2557958,5203663,14559000,22320621,0
MS,Jones County Junior College,3808681,6717113,11741000,22266794,0
AR,Southern Arkansas University,4025613,6634144,11587000,22246757,0
OK,Rose State College,3084740,6949136,12194000,22227876,0
CO,Red Rocks Community College,3149018,6889441,12160000,22198459,0
AR,Northwest Arkansas Community College,3113618,6897894,12153000,22164512,0
GA,Columbus Technical College,3131902,6948954,12081000,22161856,0
SC,South Carolina State University,4062087,6611191,11484000,22157278,0
CT,Norwalk Community College,3189661,6885402,12059000,22134063,0
MO,Missouri Western State University,3722351,6689868,11705000,22117219,0
GA,Savannah Technical College,3257084,6876107,11980000,22113191,0
CA,Clovis Community College,2870984,6951508,12276000,22098492,0
NY,Uta Mesivta Of Kiryas Joel,4265324,6530186,11301000,22096510,0
FM,College Of Micronesia-Fsm,3640313,6749563,11684000,22073876,0
MN,North Hennepin Community College,3021425,6915297,12128000,22064722,0
IA,Iowa Western Community College,3175383,6848417,12013000,22036800,0
IL,Oakton Community College,2762839,6923930,12344000,22030769,5605000
IL,Rock Valley College,3290405,6777335,11948000,22015740,0
CA,Santiago Canyon College,2893906,6866798,12250000,22010704,0
PA,Luzerne County Community College,3206325,6817714,11920000,21944039,0
PA,Edinboro University Of Pennsylvania,4181685,6446463,11298000,21926148,0
TX,St. Edward'S University,4142345,6472273,11309000,21923618,107026000
IL,Saint Xavier University,4057142,6501237,11335000,21893379,0
NY,Orange County Community College,3405395,6706076,11774000,21885471,0
CA,Solano Community College,3130214,6745292,11978000,21853506,0
NE,University Of Nebraska - Kearney,3925967,6501525,11417000,21844492,0
PA,Thomas Jefferson University,4240183,6346019,11234000,21820202,0
WA,Seattle Central College,3252598,6694704,11851000,21798302,0
WI,Chippewa Valley Technical College,2765463,6860983,12110000,21736446,0
OH,Clark State Community College,2914627,6839500,11967000,21721127,0
WA,Spokane Falls Community College,3458313,6624036,11589000,21671349,0
IL,Lewis University,3978861,6397561,11269000,21645422,0
TN,Columbia State Community College,3285220,6664682,11688000,21637902,0
PA,Villanova University,4299419,6189181,11110000,21598600,766903000
WA,Highline College,3519738,6541137,11534000,21594875,0
MD,Frostburg State University,3925040,6416427,11238000,21579467,0
OR,Rogue Community College,2523281,6927272,12117000,21567553,0
IL,Bradley University,4276013,6267487,11023000,21566500,320313000
IN,Indiana University Southeast,3667290,6482268,11350000,21499558,0
OK,Cameron University,3498279,6554643,11434000,21486922,0
MA,Framingham State University,3897751,6356373,11208000,21462124,0
PA,Bucks County Community College,3016924,6658039,11777000,21451963,0
KS,Kansas City Kansas Community College,2965092,6705791,11754000,21424883,0
GA,Athens Technical College,2983204,6704867,11704000,21392071,0
PR,Nuc University,21367165,0,0,21367165,0
NJ,Princeton University,2424099,6776453,12166000,21366552,26116022000
LA,Louisiana Delta Community College,2963756,6698731,11666000,21328487,0
CA,Los Angeles Harbor College,2906139,6734763,11668000,21308902,0
AZ,Pima Medical Institute,21285691,0,0,21285691,0
NC,Rowan-Cabarrus Community College,2845506,6289645,12132000,21267151,0
WI,University Of Wisconsin - Parkside,3781946,6364119,11118000,21264065,0
IA,Eastern Iowa Community College District,2709712,6681568,11791000,21182280,0
GA,Georgia College & State University,4082028,6172402,10926000,21180430,0
IL,Governors State University,3702601,6348024,11096000,21146625,0
IL,City Colleges Of Chicago Harry S Truman College,3220360,6444909,11446000,21111269,0
NJ,Saint Peter'S University,3914585,6239918,10870000,21024503,0
OH,Lakeland Community College,3073894,6507072,11432000,21012966,0
SC,Francis Marion University,4141139,6135642,10699000,20975781,0
FL,Saint Johns River State College,2997937,6513669,11455000,20966606,0
TN,Motlow State Community College,3178784,6450317,11329000,20958101,0
VA,Hampton University,4264342,6056070,10617000,20937412,282543000
MD,Baltimore City Community College,2876155,6576135,11481000,20933290,0
AR,Henderson State University,3767931,5968320,11157000,20893251,0
ME,Southern Maine Community College,2897298,6511012,11429000,20837310,0
NY,Saint Joseph'S College,3745728,6203959,10878000,20827687,0
IA,Iowa Central Community College,3053198,6460442,11309000,20822640,0
SC,Florence - Darlington Technical College,3137478,6442168,11220000,20799646,0
PR,Inter American University Of Puerto Rico - Barranquitas Campus,3922288,6138003,10623000,20683291,0
OR,Central Oregon Community College,3183671,6331672,11127000,20642343,22459000
NC,Coastal Carolina Community College,3371351,6284036,10986000,20641387,0
MS,Northeast Mississippi Community College,3583689,6212227,10814000,20609916,0
AL,Southern Union State Community College,3196100,6311016,11066000,20573116,0
OR,Southern Oregon University,3422079,6202456,10913000,20537535,0
CA,Biola University,3922227,6020986,10588000,20531213,0
VA,Virginia Western Community College,2763297,6437437,11316000,20516734,0
IL,Lincoln Land Community College,2715449,6445621,11348000,20509070,0
TX,Wharton County Junior College,3060606,6308810,11135000,20504416,0
WI,Concordia University,3667367,6084278,10744000,20495645,88859000
VA,Germanna Community College,2868710,6379347,11232000,20480057,0
PR,Edp University Of Puerto Rico,3158114,6321077,10994000,20473191,0
AL,Tuskegee University,3756522,6066979,10633000,20456501,0
CA,Compton College,2538405,6356599,11554000,20449004,0
NH,Plymouth State University Of The University System Of New Hampshire,3950921,5982786,10512000,20445707,0
GA,Abraham Baldwin Agricultural College,3489407,6153343,10752000,20394750,0
TX,Temple College,2937041,6348038,11093000,20378079,0
GA,Gordon State College,3427492,6168119,10743000,20338611,0
PR,Inter American University Of Puerto Rico - Fajardo Campus,3814392,6041453,10462000,20317845,0
CA,Porterville College,2896753,6326756,11032000,20255509,0
OH,University Of Northwestern Ohio,3906341,5948044,10382000,20236385,0
RI,New England Institute Of Technology,3676041,6026805,10495000,20197846,0
OH,Central State University,3645811,6020363,10498000,20164174,0
AL,Shelton State Community College,2965439,6242835,10927000,20135274,0
IL,National Louis University,3034098,6209964,10891000,20135062,36103000
TN,Jackson State Community College,2838469,6278510,10978000,20094979,0
NY,Suny College Of Agriculture & Technology At Morrisville,3527241,5952000,10461000,19940241,0
WA,Evergreen State College (The),3787631,5880338,10261000,19928969,0
MN,St. Cloud Technical And Community College,3055197,6143474,10723000,19921671,0
IL,Roosevelt University,2927478,8905677,8047000,19880155,123353000
MO,Webster University,3517058,5874946,10478000,19870004,139792000
KY,Elizabethtown Community And Technical College,2426734,6335828,11106000,19868562,0
MS,East Mississippi Community College,3398901,5993735,10469000,19861636,0
TN,Lee University,3518557,5925628,10395000,19839185,1676308000
NM,Eastern New Mexico University,2914187,6119843,10775000,19809030,0
VA,College Of William & Mary,3948268,5677858,10171000,19797126,0
NM,San Juan College,2737168,6182593,10848000,19767761,0
IL,Richard J Daley College-City Colleges Of Chicago,2993998,6024050,10705000,19723048,0
AZ,Gateway Community College,2707626,6158634,10826000,19692260,0
WV,Fairmont State University,3426559,5924797,10339000,19690356,0
MN,Minnesota State University Moorhead,3518533,5854257,10305000,19677790,0
NC,Durham Technical Community College,2803141,6117402,10738000,19658543,0
WA,Seattle University,3692919,5744310,10209000,19646229,0
CA,Contra Costa College,2477887,6196600,10939000,19613487,0
AZ,Paradise Valley Community College,2586404,6141870,10876000,19604274,0
OK,Southwestern Oklahoma State University,3443513,5864883,10278000,19586396,0
SC,Claflin University,3738216,5789854,10043000,19571070,0
WA,Olympic College,3129109,5935959,10501000,19566068,0
KS,Fort Hays State University,2524075,6157168,10826000,19507243,114719000
CA,Las Positas College,2875491,5984875,10643000,19503366,0
WA,Edmonds Community College,2887689,5970004,10611000,19468693,0
OR,Linn-Benton Community College,2606675,6082320,10750000,19438995,0
AZ,Central Arizona College,3010509,5964675,10450000,19425184,0
MI,Davenport University,2925271,5986150,10488000,19399421,0
AL,Bishop State Community College,2871392,6026297,10500000,19397689,0
IL,Lake Land College,2510560,6026021,10796000,19332581,0
SC,York Technical College,3059291,5917462,10349000,19325753,0
OH,Xavier University,3122063,4794656,8554000,16470719,199275000
WA,Clover Park Technical College,3266340,5802995,10181000,19250335,0
CA,West Los Angeles College,2215810,6229160,10784000,19228970,0
CA,Pepperdine University,3620831,5540475,10054000,19215306,887461000
KY,West Kentucky Community And Technical College,2444514,6080214,10657000,19181728,0
CA,Foothill College,2401437,5970543,10790000,19161980,0
TX,University Of Mary Hardin-Baylor,3548693,5677713,9921000,19147406,0
SC,Central Carolina Technical College,2841256,5948759,10355000,19145015,0
MN,Minnesota State Community And Technical College,2832620,5922783,10388000,19143403,0
AR,University Of Arkansas At Monticello,3223313,5805440,10106000,19134753,0
KY,University Of The Cumberlands,2796798,5852797,10445000,19094595,0
GA,Wiregrass Georgia Technical College,2558893,6012298,10523000,19094191,0
PR,Commonwealth Of Puerto Rico Department Of Education,3315937,5761089,9981000,19058026,0
MA,Quincy College,2770136,5711961,10529000,19011097,0
TX,Weatherford College,2547296,5967424,10494000,19008720,0
NJ,Rider University,3648210,5567041,9779000,18994251,66593000
KS,Emporia State University,3517620,5594046,9837000,18948666,79116000
IL,Illinois Institute Of Technology,3730000,5464457,9704000,18898457,236887000
WA,South Puget Sound Community College,2999739,5742134,10079000,18820873,0
SC,Lander University,3536994,5567453,9700000,18804447,0
CA,Skyline College,2491579,5852939,10457000,18801518,0
NY,Finger Lakes Community College - Suny Office Of Community Colleges,2655728,5791370,10326000,18773098,0
MA,Berklee College Of Music,3573148,5472491,9683000,18728639,363026000
IL,Prairie State College,2523787,5872996,10316000,18712783,0
AZ,Yavapai College,2389592,5918433,10403000,18711025,0
IL,South Suburban College Of Cook County,2208424,5973385,10515000,18696809,0
CA,Monterey Peninsula College,2415633,5845034,10372000,18632667,0
PR,Caribbean University,3713976,5445854,9468000,18627830,0
PA,Lincoln University,3494532,5521219,9589000,18604751,0
OH,Shawnee State University,3572909,5463226,9540000,18576135,19300000
CO,Colorado Christian University,2267714,5912413,10393000,18573127,0
MD,University Of Maryland - Eastern Shore,3542365,5476295,9553000,18571660,0
CT,University Of Bridgeport,3271938,5533358,9724000,18529296,0
PR,Atlantic University College,3392323,5519097,9614000,18525420,0
PR,Inter American University Of Puerto Rico - Guayama Campus,3353951,5534682,9589000,18477633,0
LA,Xavier University Of Louisiana,3227606,5542343,9670000,18439949,0
OH,Eastern Gateway Community College,928466,6354688,11129000,18412154,0
CA,Ohlone College,2555988,5652458,10123000,18331446,0
MA,Wentworth Institute Of Technology,3469571,5314247,9539000,18322818,116142000
NC,University Of North Carolina Asheville,3359493,5428515,9499000,18287008,0
CO,Aims Community College,2541187,5693412,10034000,18268599,0
TX,Angelina College,2612956,5694082,9961000,18268038,0
IL,Morton College,2532643,5709962,10014000,18256605,0
TX,Texarkana College,2568337,5694732,9946000,18209069,0
KY,Berea College,3516276,5326942,9337000,18180218,1218740000
MN,Hennepin Technical College,2654457,5636807,9882000,18173264,0
AZ,Cochise College,3163235,5418622,9586000,18167857,0
LA,Southern University At Shreveport - Bossier City,2595115,5665245,9852000,18112360,0
CA,San Jose City College,2274964,5691504,10144000,18110468,0
GA,East Georgia State College,2879553,5552828,9657000,18089381,0
CA,California Lutheran University,3451376,5298324,9315000,18064700,108602000
FL,Stetson University,3578583,5217973,9256000,18052556,255416000
PA,Clarion University Of Pennsylvania,3224275,5388310,9436000,18048585,0
NY,College Of Saint Rose,3475163,5285743,9263000,18023906,0
MO,Maryville University Of Saint Louis,3144097,5370742,9494000,18008839,0
PA,Lehigh University,3616135,5150737,9206000,17972872,1411641000
NC,Wingate University,3526458,5245491,9189000,17960949,0
MO,Crowder College,2638696,5563380,9748000,17950076,0
CA,Santa Clara University,3542678,5143956,9242000,17928634,1019760000
TX,University Of North Texas At Dallas,3036810,5421911,9454000,17912721,0
AZ,Scottsdale Community College,2386925,5584623,9933000,17904548,0
MN,Rochester Community And Technical College,2629500,5542245,9711000,17882745,0
CA,College Of The Redwoods,2504489,5589825,9784000,17878314,0
MO,Saint Charles Community College,2682474,5488788,9694000,17865262,0
CT,Goodwin University,2365797,5191240,10288000,17845037,0
NE,Central Community College,1890454,4636930,8176000,14703384,0
AL,Miles College,3257934,5320726,9211000,17789660,0
KS,Wichita State University Campus Of Applied Sciences And Technology,2383798,5577556,9809000,17770354,0
NY,Marist College,3344611,5195563,9219000,17759174,0
MD,College Of Southern Maryland,2579022,5480447,9683000,17742469,0
MS,Meridian Community College,2940110,5382355,9402000,17724465,0
MA,Mount Wachusett Community College,2554747,5520672,9634000,17709419,0
GA,Georgia Piedmont Technical College,2699452,5465270,9522000,17686722,0
IL,Benedictine University,3297892,5212121,9176000,17686013,0
CA,Los Angeles Southwest College,2222854,5686223,9755000,17664077,0
MA,Springfield College,3458881,5146652,9041000,17646533,77932000
PA,Lock Haven University Of Pennsylvania,3395845,5183846,9060000,17639691,0
CA,Mount Saint Mary'S University,3135747,5279211,9199000,17613958,0
NV,Nevada State College,2755743,5390156,9445000,17590899,0
ID,College Of Southern Idaho,2076917,5569456,9878000,17524373,0
AL,Bevill State Community College,2642839,5413481,9466000,17522320,0
MO,Truman State University,3345344,5119742,9038000,17503086,0
NC,University Of Mount Olive,3337015,5154411,8990000,17481426,0
CA,University Of Redlands,3388020,5125485,8960000,17473505,182278000
UT,Snow College,2478311,5443723,9550000,17472034,0
PA,Point Park University,3193085,5185309,9085000,17463394,0
CT,Three Rivers Community College,2253229,5525543,9646000,17424772,0
IN,Indiana University - Northwest,2947212,5265615,9210000,17422827,0
CO,Arapahoe Community College,2079610,5512598,9808000,17400208,0
PA,Robert Morris University,3326878,5091859,8980000,17398737,37013000
OH,Baldwin Wallace University,3370528,5075637,8900000,17346165,179533000
PA,York College Of Pennsylvania,3283784,5089255,8951000,17324039,0
PR,Dewey University,3138599,5187169,8998000,17323768,0
FL,Florida Career College,17303589,0,0,17303589,0
KY,Southcentral Kentucky Community And Technical College,2424487,5410058,9461000,17295545,0
MO,Moberly Area Community College,2410386,5357897,9390000,17158283,0
OR,Clackamas Community College,1724926,5558561,9864000,17147487,0
VA,Longwood University,3220578,5039427,8881000,17141005,71363000
NH,Dartmouth College,3429350,4920074,8780000,17129424,5731322000
SC,University Of South Carolina - Aiken,3065412,5107433,8929000,17101845,0
NC,Gaston College,2520848,5286161,9276000,17083009,0
MN,Augsburg University,3259242,5018026,8777000,17054268,50786000
OK,East Central University,3066346,5075356,8875000,17016702,0
GA,College Of Coastal Georgia,2811985,5167644,9024000,17003629,0
IL,Elmhurst College,3320646,4964496,8694000,16979142,112339000
CO,Colorado School Of Mines,3445115,4867096,8657000,16969211,289011000
MO,Jefferson College,2610155,5214046,9130000,16954201,134923000
GA,Albany Technical College,2451149,5281805,9185000,16917954,0
HI,University Of Hawaii At Hilo,2994725,5063323,8848000,16906048,0
TX,Rice University,3433160,4823060,8644000,16900220,6481102000
CA,Gavilan College,2328197,5265223,9285000,16878420,0
NY,Genesee Community College,2484880,5220960,9165000,16870840,0
PA,Pittsburgh Technical College,3296079,4947069,8599000,16842148,0
MS,Mississippi Valley State University,3079829,5002955,8694000,16776784,0
VA,Ecpi University,16762368,0,0,16762368,0
FL,Northwest Florida State College,2530500,5151977,9069000,16751477,0
MS,Copiah-Lincoln Community College,3359493,4876965,8505000,16741458,0
OK,Oklahoma State University - Oklahoma City,2300829,5237822,9199000,16737651,0
CA,West Hills College Lemoore,2260143,5260554,9204000,16724697,0
IL,Mchenry County College,2254053,5209015,9252000,16715068,0
MS,Mississippi Delta Community College,2743944,5097200,8873000,16714144,0
NC,Davidson County Community College,2636381,5117842,8944000,16698223,0
NY,Molloy College,2677888,5050913,8965000,16693801,40759000
MN,Bemidji State University,2813298,5037376,8841000,16691674,0
MO,State Fair Community College,2466914,5177384,9045000,16689298,0
NY,Manhattan College,3277749,4863451,8546000,16687200,107174000
NY,Schenectady County Community College,2266692,5230881,9173000,16670573,0
OH,Hocking Technical College,2402471,4437556,9826000,16666027,0
OK,Langston University,3082441,4959009,8623000,16664450,0
MD,Hagerstown Community College,2358314,5202597,9101000,16661911,0
PA,Mercyhurst University,3142547,4900955,8574000,16617502,0
NC,Wake Forest University,3404708,4711472,8497000,16613180,1375398000
MI,Mid Michigan College,2641059,5077764,8873000,16591823,0
NE,Creighton University,3193341,4790999,8602000,16586340,587024000
PA,Westmoreland County Community College,2377450,5157844,9051000,16586294,0
LA,Sowela Technical Community College,2493383,5120697,8938000,16552080,0
TX,Paris Junior College,2287333,5177107,9086000,16550440,0
AR,Harding University,3252861,4801524,8490000,16544385,151411000
MD,Harford Community College,2343664,5126050,9033000,16502714,0
CO,Fort Lewis College,3038637,4891889,8553000,16483526,0
LA,Northshore Technical Community College,2051300,5242703,9180000,16474003,0
FL,Gulf Coast State College,2415469,5086482,8929000,16430951,0
VA,Lord Fairfax Community College,2319604,5100496,9010000,16430100,0
OK,Oral Roberts University,2933238,4896140,8574000,16403378,0
NC,Central Carolina Community College,2422099,5053041,8873000,16348140,0
OK,Rogers State University,2586804,4985775,8699000,16271579,0
NY,Iona College,3070913,4776064,8388000,16234977,159938000
WA,Skagit Valley College,2333763,5028156,8855000,16216919,0
MI,University Of Detroit Mercy,3105323,4735579,8375000,16215902,69300000
MS,Mississippi College,3011426,4766371,8411000,16188797,0
CA,Mission College,1961952,5091885,9064000,16117837,0
KS,Hutchinson Community College,2304535,5003358,8807000,16114893,0
FL,Lake Sumter State College,2306379,5012441,8790000,16108820,0
WI,Western Technical College,2379444,4982783,8723000,16085227,0
TX,St. Mary'S University,3180524,4682898,8205000,16068422,196463000
CT,Capital Community College,2032022,5110446,8912000,16054468,0
NY,Suny College Of Technology At Canton,2510929,4928910,8605000,16044839,0
OK,Platt College,16031127,0,0,16031127,0
CT,Tunxis Community College,2185505,5023592,8790000,15999097,0
WA,Walla Walla Community College,2487718,4896390,8601000,15985108,0
NY,Adirondack Community College - Suny Office Of Community Colleges,2558377,4876146,8532000,15966523,0
TX,Abilene Christian University,2982741,4691178,8274000,15947919,451731000
MD,Coppin State University,2727906,4822740,8397000,15947646,0
AZ,South Mountain Community College,2098614,5018347,8783000,15899961,0
IL,Olivet Nazarene University,2972237,4678981,8226000,15877218,0
IL,Dominican University,3025781,4672507,8168000,15866288,40445000
WI,Waukesha County Technical College,1935258,5001888,8907000,15844146,0
TN,Bethel University,2121073,4986720,8720000,15827793,0
TX,Wayland Baptist University,2509726,4830767,8477000,15817493,0
NJ,Stevens Institute Of Technology,3121706,4477648,8178000,15777354,224304000
SC,Charleston Southern University,2880272,4678162,8199000,15757434,0
MA,Brandeis University,3198465,4452458,8100000,15750923,1073526000
TX,Coastal Bend College,2133542,4928107,8661000,15722649,0
NC,Alamance Community College,2367785,4848030,8490000,15705815,0
CA,Point Loma Nazarene University,2913693,4628536,8162000,15704229,0
AR,National Park College,2285507,4894868,8515000,15695375,0
IL,Lewis And Clark Community College,2062380,4918298,8706000,15686678,0
ID,North Idaho College,2161877,4907648,8601000,15670525,0
WA,Whatcom Community College,2392620,4813638,8456000,15662258,0
LA,Loyola University New Orleans,2913258,4604038,8097000,15614296,0
MN,St. Catherine University,2645045,4698756,8253000,15596801,0
IN,Valparaiso University,3107360,4509425,7931000,15547785,259042000
IN,Butler University,3005303,4482000,7988000,15475303,0
FL,Altierus Career College,2524835,4730783,8205000,15460618,0
MS,William Carey University,2370656,4715985,8366000,15452641,0
HI,Leeward Community College,2067889,4835134,8543000,15446023,0
NY,Culinary Institute Of America,2997253,4507864,7909000,15414117,138298000
TX,Alvin Community College,2277498,4736789,8388000,15402287,0
WA,Shoreline Community College,2438333,4668215,8266000,15372548,0
IL,City Colleges Of Chicago - Kennedy King College,2144024,4811192,8414000,15369216,0
MI,Kellogg Community College,1991422,4855538,8521000,15367960,0
MI,Muskegon Community College,2247350,4751064,8332000,15330414,0
WV,Shepherd University,2679616,4591465,8052000,15323081,22145000
AK,University Of Alaska Fairbanks,2066651,4781679,8471000,15319330,0
GA,Morehouse College,2947819,4484089,7809000,15240908,0
MO,Drury University,2470201,4648448,8120000,15238649,96517000
AZ,Eastern Arizona College,2222272,4692651,8320000,15234923,0
PA,Widener University,2794641,4469255,7949000,15212896,94454000
VA,University Of Mary Washington,2888681,4448919,7856000,15193600,55479000
TX,Trinity Valley Community College,1865240,4808492,8454000,15127732,0
IL,Heartland Community College,2092953,4701213,8324000,15118166,0
MO,Lincoln University,2565804,4575902,7973000,15114706,0
NH,Keene State College,2997360,4391814,7719000,15108174,0
NC,Elon University,2989232,4333388,7770000,15092620,273429000
IL,Black Hawk College,2172992,4663525,8230000,15066517,0
NY,Jefferson Community College,2361051,4618540,8068000,15047591,0
GA,South Georgia State College,2422737,4591608,7997000,15011345,0
GA,Lanier Technical College,2122657,4680489,8201000,15004146,0
NJ,Bloomfield College,2851037,4441931,7705000,14997968,0
NY,Jamestown Community College,2306997,4608853,8082000,14997850,0
CA,United Education Institute,14992982,0,0,14992982,0
TX,Odessa College,2118029,4719893,8126000,14963922,0
AZ,Universal Technical Institute,14950305,0,0,14950305,0
MO,Three Rivers College,2281288,4609172,8030000,14920460,0
CA,Berkeley City College,1844524,4706915,8362000,14913439,0
PA,University Of Scranton,2938777,4297505,7645000,14881282,209760000
WA,Pacific Lutheran University,2935869,4339965,7604000,14879834,0
IA,Upper Iowa University,2210375,4587064,8048000,14845439,0
CA,College Of San Mateo,2042860,4571602,8217000,14831462,0
MS,East Central Community College,2606310,4456077,7763000,14825387,0
WA,Seattle Pacific University,2890475,4324878,7602000,14817353,124901000
NY,Suny College Of Technology At Delhi,2436849,4511025,7867000,14814874,0
TN,Lincoln Memorial University,2657937,4377528,7741000,14776465,0
MS,Coahoma Community College,3136873,4236381,7353000,14726254,0
GA,North Georgia Technical College,2114032,4588972,7992000,14695004,0
TX,Houston Baptist University,2615603,4386077,7689000,14690680,0
IL,John A. Logan College,1452644,4729234,8501000,14682878,0
NY,Suny College Of Agriculture & Technology At Cobleskill,2747860,4345324,7583000,14676184,0
MO,Harris - Stowe State University,2513580,4447990,7712000,14673570,0
IA,Hawkeye Community College,1769048,4673024,8230000,14672072,0
WA,Whitworth University,2840748,4295420,7526000,14662168,156048000
CA,West Valley College,2016079,4531612,8107000,14654691,0
IA,Western Iowa Tech Community College,2023618,4573145,8036000,14632763,0
LA,Southern University At New Orleans,2481663,4428953,7714000,14624616,0
KY,Maysville Community And Technical College,1992396,4591401,8018000,14601797,0
AZ,Mohave Community College,1933935,4605866,8050000,14589801,0
ME,Husson University,2674616,4321707,7574000,14570323,0
IN,Indiana University - Kokomo,2505620,4384864,7668000,14558484,0
NY,Saint Francis College,2673260,4322861,7549000,14545121,0
NY,Pratt Institute,2831205,4188674,7518000,14537879,215667000
AR,Arkansas State University - Beebe,2141764,4498666,7872000,14512430,0
HI,Kapiolani Community College,2022941,4484284,7954000,14461225,0
NC,Johnson C Smith University,2718468,4307958,7432000,14458426,0
AL,Northwest - Shoals Community College,2069470,4505213,7879000,14453683,0
PA,Saint Joseph'S University,2796324,4168820,7447000,14412144,294287000
TX,Grayson College,2157844,4451723,7796000,14405567,0
GA,Atlanta Metropolitan State College,2149954,4464596,7767000,14381550,0
GA,Spelman College,2804294,4189279,7384000,14377573,390462000
WA,Wenatchee Valley College,2466867,4320320,7585000,14372187,0
NE,Wayne State College,2521559,4301037,7547000,14369596,0
PA,Gannon University,2684679,4223568,7455000,14363247,65364000
VA,Christopher Newport University,2893936,4128127,7326000,14348063,0
AL,Faulkner University,2422978,4333744,7569000,14325722,15240000
MS,Delta State University,2524437,4272713,7524000,14321150,0
WA,Gonzaga University,2772507,4090622,7394000,14257129,294720000
KY,Lindsey Wilson College,2587859,4250842,7417000,14255701,0
CO,Regis University,2448686,4210720,7494000,14153406,69773000
OK,Northern Oklahoma College,1971017,4421809,7755000,14147826,0
FL,South Florida State College,2111445,4384283,7646000,14141728,0
AZ,Arizona College,3665308,0,,3665308,0
KY,Big Sandy Community And Technical College,1809773,4476232,7816000,14102005,0
FL,Flagler College,2708794,4137808,7247000,14093602,69919000
VT,Community College Of Vermont,1480650,4566679,8031000,14078329,0
IL,Chicago State University,2172014,4327173,7555000,14054187,0
MD,University Of Baltimore,2325946,4240961,7476000,14042907,49878000
NY,Le Moyne College,2709704,4105843,7215000,14030547,0
CA,Napa Valley College,2125082,4281704,7585000,13991786,0
MA,Merrimack College,2646845,4085510,7245000,13977355,0
IA,University Of Dubuque,2637393,4067317,7267000,13971710,160530000
TN,Lane College,2430978,4224957,7306000,13961935,0
MA,Worcester Polytechnic Institute,2707195,4013416,7195000,13915611,528287000
WI,Blackhawk Technical College,2201888,4269703,7428000,13899591,0
NY,Niagara University,2711396,4034215,7103000,13848611,97242000
VA,Piedmont Virginia Community College,1892438,4324347,7628000,13844785,0
KY,Owensboro Community & Technical College,1789723,4372164,7652000,13813887,0
TX,University Of Houston - Victoria,2233006,4184394,7374000,13791400,0
AL,University Of West Alabama,2384585,4135471,7266000,13786056,0
GA,Coastal Pines Technical College,1758137,4368692,7653000,13779829,0
NY,Saint John Fisher College,2681804,3994698,7039000,13715502,0
MT,Montana State University - Billings,2193195,4180539,7339000,13712734,0
NY,Utica College,2388832,4099539,7224000,13712371,24796000
NC,Johnston Community College,2258380,4152736,7290000,13701116,0
LA,Louisiana State University At Eunice,2060199,4236259,7391000,13687458,0
FL,Rollins College,2692112,3898553,7085000,13675665,379841000
AL,University Of Montevallo,2560001,4041651,7060000,13661652,0
TN,Lipscomb University,2582024,3982698,7074000,13638722,84430000
RI,Roger Williams University,2629911,3959064,7041000,13629975,86049000
MA,Emerson College,2734314,3921763,6964000,13620077,0
IA,Indian Hills Community College,2199657,4137403,7264000,13601060,0
OK,University Of Tulsa (The),2645588,3954569,7000000,13600157,0
NC,Chowan University,2614325,4018655,6964000,13596980,0
MS,Southwest Mississippi Community College,2320170,4117342,7158000,13595512,0
OK,Southeastern Oklahoma State University,2118149,4153547,7287000,13558696,0
TX,Northeast Lakeview College,1343444,4407215,7799000,13549659,0
NC,Sandhills Community College,2033057,4181526,7335000,13549583,0
MD,Stevenson University,2499743,4005614,7033000,13538357,0
NY,Tompkins Cortland Community College,1845177,4215523,7470000,13530700,0
SC,Orangeburg - Calhoun Technical College,1996646,4204932,7325000,13526578,0
WI,Carthage College,2668496,3851906,6990000,13510402,111496000
VA,Blue Ridge Community College,1862031,4228308,7418000,13508339,9499000
MA,Western New England University,2684604,3915648,6902000,13502252,56683000
KY,Gateway Community And Technical College,1797783,4249192,7444000,13490975,0
CA,Crafton Hills College,1933930,4149254,7390000,13473184,0
MA,Bentley University,2665628,3883553,6918000,13467181,0
MN,Hamline University,2570227,3943823,6945000,13459050,100550000
MO,Southwest Baptist University,2301587,4056193,7100000,13457780,0
MI,Northwestern Michigan College,2124216,4118115,7197000,13439331,0
CA,Center For Employment Training,2223425,4089677,7122000,13435102,0
OR,George Fox University,2589776,3921838,6923000,13434614,0
NY,Siena College,2620637,3899632,6853000,13373269,0
MD,Frederick Community College,1851890,4147691,7351000,13350581,0
MD,Wor-Wic Community College,1860894,4183209,7303000,13347103,0
RI,Providence College,2699566,3830403,6812000,13341969,234228000
IN,Lincoln College Of Technology,13341054,0,0,13341054,0
NY,Clarkson University,2590707,3872273,6845000,13307980,201698000
OR,University Of Portland,2672004,3830681,6796000,13298685,0
MO,College Of The Ozarks,2518807,3934298,6838000,13291105,476624000
OR,Oregon Institute Of Technology,1807273,4145176,7337000,13289449,0
CA,Merritt College,1497283,4233724,7541000,13272007,0
PA,Albright College,2569568,3863482,6801000,13234050,77103000
MI,Calvin University,2639029,3829529,6764000,13232558,176538000
MD,Loyola University Maryland,2612460,3800541,6789000,13202001,232473000
FL,Palm Beach Atlantic University,2363047,3920083,6904000,13187130,85236000
NC,Livingstone College,2503063,3910216,6771000,13184279,0
MN,Lake Superior College,1757151,4132002,7292000,13181153,0
PA,Wilkes University,2403446,3896453,6879000,13178899,54044000
NC,High Point University,2605940,3731389,6826000,13163329,64777000
TN,Cleveland State Community College,1970716,4067122,7121000,13158838,0
VA,Central Virginia Community College,1817818,4111607,7215000,13144425,0
MN,South Central College,1873482,4096933,7173000,13143415,0
LA,Dillard University,2442809,3903275,6762000,13108084,0
AL,Northeast Alabama Community College,1901781,4075756,7117000,13094537,0
ME,Central Maine Community College,1882719,4059822,7081000,13023541,0
TX,Hill College,1336557,4231488,7454000,13022045,217240000
OK,Oklahoma State University Institute Of Technology - Okmulgee,2248014,3918800,6839000,13005814,0
MS,Belhaven University,2204818,3919675,6880000,13004493,0
TN,Southern Adventist University,2443809,3826927,6704000,12974736,46402000
CA,Saint Mary'S College Of California,2525736,3766129,6662000,12953865,181313000
MO,Central Methodist University,1766287,3984117,7192000,12942404,0
MN,Bethel University,2452828,3803833,6679000,12935661,0
IA,Northeast Iowa Community College,1835580,4009002,7056000,12900582,0
TX,University Of Texas Of The Permian Basin,1840016,4007546,7050000,12897562,0
IL,North Park University,2332872,3834812,6712000,12879684,79527000
NY,Yeshiva University,2479795,3711922,6680000,12871717,665001000
LA,Louisiana State University At Alexandria,1998555,3959812,6911000,12869367,0
PA,Arcadia University,2563133,3728760,6577000,12868893,82645000
SC,"Citadel, The Military College Of South Carolina",2499158,3698438,6663000,12860596,0
KY,Ashland Community And Technical College,1897125,3997808,6961000,12855933,0
VA,Regent University,1567327,4071730,7153000,12792057,0
OH,Capital University,2486868,3710353,6534000,12731221,106663000
OH,Central Ohio Technical College,1667250,4014980,7042000,12724230,0
CA,Taft College,1122910,4175867,7421000,12719777,0
GA,South Georgia Technical College,1870108,3954455,6883000,12707563,0
MI,St. Clair County Community College,1909478,3923106,6873000,12705584,0
PA,Lackawanna College,1885348,3937122,6882000,12704470,0
NC,North Carolina Wesleyan College,2177353,3837299,6674000,12688652,0
MA,Massachusetts Bay Community College,1775751,3944066,6968000,12687817,0
TX,College Of The Mainland,1767883,3950300,6957000,12675183,0
TX,Midland College,1673002,3920402,7073000,12666404,0
ID,Lewis-Clark State College,1979771,3877118,6799000,12655889,0
IL,North Central College,2410282,3713512,6517000,12640794,118586000
WA,North Seattle College,1795310,3896932,6946000,12638242,0
FL,Jacksonville University,2208846,3764301,6641000,12614147,46743000
MN,Ridgewater College,1950916,3860185,6761000,12572101,95758000
NY,Corning Community College - Suny Office Of Community Colleges,1937448,3844791,6752000,12534239,0
WI,Northcentral Technical College,1482377,3991652,7055000,12529029,0
MS,Mississippi University For Women,2188061,3763183,6566000,12517244,0
PA,Butler County Community College,1882832,3855833,6762000,12500665,0
TX,Cisco College,1817547,3864761,6771000,12453308,0
TX,Dallas Baptist University,2198677,3689859,6525000,12413536,0
AL,H. Councill Trenholm State Community College,1892834,3837980,6679000,12409814,0
NC,Richmond Community College,1993968,3796431,6618000,12408399,0
KY,Bellarmine University,2469277,3570531,6298000,12337808,66331000
IA,Drake University,2224225,3636645,6470000,12330870,226155000
HI,Brigham Young University - Hawaii,2306881,3626535,6397000,12330416,0
NJ,Felician University,2243499,3667867,6395000,12306366,0
NY,Medaille College,2028538,3721180,6510000,12259718,0
LA,Elaine P. Nunez Community College,1561099,3892436,6782000,12235535,0
OH,Cedarville University,2294323,3591516,6346000,12231839,36485000
MO,Mineral Area College,1986137,3722656,6504000,12212793,0
LA,Louisiana State University In Shreveport,1825886,3754151,6628000,12208037,0
VA,University Of Richmond,2425545,3524203,6256000,12205748,2517969000
NC,Elizabeth City State University,2130978,3679189,6391000,12201167,0
WA,South Seattle College,1861609,3692544,6629000,12183153,0
KY,Southeast Kentucky Community And Technical College,1616993,3839470,6717000,12173463,0
NC,Wayne Community College,1871243,3744411,6553000,12168654,0
PA,Eastern University,2228030,3602009,6325000,12155039,1055474000
MA,Roxbury Community College,1677144,3819450,6649000,12145594,0
FL,Florida Southern College,2291992,3566789,6280000,12138781,79136000
MH,College Of The Marshall Islands,1956673,3719492,6438000,12114165,0
CA,San Joaquin Valley College,12104128,0,0,12104128,0
NY,College Of Mount Saint Vincent,2592348,3459827,6034000,12086175,0
WV,West Liberty University,2246663,3578510,6260000,12085173,0
NE,Northeast Community College,1729207,3746465,6605000,12080672,0
CO,Colorado Mountain College,1694667,3735220,6647000,12076887,0
NC,Methodist University,1925342,2957602,5175000,10057944,1663864000
NH,Nhti - Concord'S Community College,1806576,3714959,6544000,12065535,0
CA,La Sierra University,2144179,3606411,6301000,12051590,0
MN,Inver Hills Community College,1718868,3737337,6585000,12041205,0
CA,Woodland Community College,1623074,3766737,6640000,12029811,0
SC,Aiken Technical College,1824100,3718101,6480000,12022201,0
NC,Caldwell Community College & Technical Institute,1753469,3728354,6538000,12019823,0
IL,Millikin University,2299043,3534156,6172000,12005199,106893000
CA,Barstow Community College,1556808,3808377,6639000,12004185,0
TX,Lamar Institute Of Technology,1836301,3711898,6453000,12001199,0
WA,Lower Columbia College,1810047,3702313,6473000,11985360,0
NY,Vaughn College Of Aeronautics And Technology,2140817,3593590,6248000,11982407,24465000
NC,Shaw University,2258545,3540428,6140000,11938973,0
OH,University Of Findlay (The),2250867,3488769,6194000,11933636,0
DC,Catholic University Of America (The),2374572,3406832,6148000,11929404,0
WI,Carroll University,2437429,3503766,6181000,12122195,223539000
NY,Canisius College,2334830,3470452,6108000,11913282,129201000
TN,Carson - Newman University,2295168,3490978,6121000,11907146,0
MN,College Of Saint Scholastica,2274924,3476779,6137000,11888703,0
MO,Ranken Technical College,2185927,3523730,6137000,11846657,0
WA,Bellingham Technical College,1833051,3642353,6361000,11836404,0
OK,Carl Albert State College,1880688,3626361,6309000,11816049,0
CT,Fairfield University,2137358,3463328,6206000,11806686,374896000
AL,Samford University,2381353,3353321,6072000,11806674,0
CA,West Coast University,11797821,0,0,11797821,0
NY,Cayuga Community College - Suny Office Of Community College,1497604,3718340,6559000,11774944,0
OR,Pacific University,2323471,3403723,6046000,11773194,124901000
MN,Southwest Minnesota State University,1644234,3629923,6487000,11761157,0
OK,Connors State College,1785542,3639242,6336000,11760784,0
MA,Lesley University,1997859,3513514,6244000,11755373,187972000
VA,New River Community College,1658163,3654725,6439000,11751888,0
LA,River Parishes Community College,963683,3913055,6859000,11735738,0
NY,State University Of New York Polytechnic Institute,2129510,3490152,6116000,11735662,0
CA,Art Center College Of Design,2168231,3469092,6091000,11728323,0
TX,Victoria College,1680905,3650333,6396000,11727238,0
VA,Virginia Union University,2251677,3451922,6021000,11724599,0
NE,Bellevue University,1169139,3824467,6710000,11703606,0
VA,Southside Virginia Community College,1677846,3641711,6382000,11701557,0
AR,University Of Arkansas Community College At Morrilton,1861056,3589050,6247000,11697106,0
PR,Universidad Adventista De Las Antillas,2178276,3474235,6026000,11678511,0
WA,Renton Technical College,1717551,3599677,6356000,11673228,0
TX,Texas College,2358852,3406198,5902000,11667050,0
VT,Northern Vermont University,1932341,3530182,6161000,11623523,0
VA,Southwest Virginia Community College,1671535,3623306,6309000,11603841,0
VT,Norwich University,2004614,3477779,6121000,11603393,0
WI,Milwaukee School Of Engineering,2285262,3379921,5936000,11601183,0
TX,Vernon College,1381106,3712194,6489000,11582300,0
OH,John Carroll University,2224405,3380237,5976000,11580642,223539000
TX,Sul Ross State University,1779991,3571688,6224000,11575679,0
OK,Northeastern Oklahoma A & M College,1934724,3512456,6119000,11566180,0
AL,Talladega College,2069544,3454443,5987000,11510987,0
TX,Our Lady Of The Lake University,2078279,3418669,5998000,11494948,0
PR,Colegio Universitario De San Juan,2002902,3471401,6012000,11486303,0
VA,Danville Community College,1604222,3591706,6289000,11484928,0
OH,Otterbein University,2255286,3344331,5879000,11478617,101386000
SC,University Of South Carolina - Beaufort,2075254,3423472,5972000,11470726,0
CA,California College San Diego,2281144,3504173,5668000,11453317,0
TX,University Of Saint Thomas,1984472,3430711,6036000,11451183,0
SC,Anderson University,2092286,3389001,5968000,11449287,0
ME,University Of Maine - Farmington,2158052,3371441,5885000,11414493,0
NY,Monroe College,11408077,0,0,11408077,0
MN,Rasmussen College,11388948,0,0,11388948,0
TX,Vista College,11351349,0,0,11351349,0
MN,Central Lakes College,1658191,3507873,6185000,11351064,0
CT,Wesleyan University,2257086,3252068,5837000,11346154,1004806000
AR,Philander Smith College,2143674,3363217,5820000,11326891,0
MA,Endicott College,2063007,3324451,5921000,11308458,95673000
SC,North Greenville University,2143104,3311855,5806000,11260959,0
FL,Florida Memorial University,2154643,3325368,5770000,11250011,0
PA,Holy Family University,2023957,3344930,5881000,11249887,0
CO,Emily Griffith Technical College,1828725,3372652,6045000,11246377,0
OH,Ohio Christian University,1748170,3453072,6022000,11223242,0
VA,Marymount University,2074937,3297419,5826000,11198356,0
MO,East Central College,1651321,3471107,6066000,11188428,0
IL,School Of The Art Institute Of Chicago,2167774,3250859,5763000,11181633,0
OH,Ohio Northern University,2189709,3255742,5733000,11178451,160300000
KS,Ottawa University,1667633,3455105,6044000,11166738,0
OH,University Of Mount Union,2209587,3235680,5714000,11159267,140318000
CA,College Of Marin,1347945,3526729,6281000,11155674,0
KY,Hopkinsville Community College,1399325,3556627,6197000,11152952,0
CA,Vanguard University Of Southern California,1879831,3373721,5899000,11152552,0
GA,Ogeechee Technical College,1622353,3469544,6046000,11137897,0
IL,Kankakee Community College,1267153,3574930,6278000,11120083,0
WV,Concord University,2057014,3299115,5763000,11119129,0
IN,Trine University,1800977,3358765,5958000,11117742,0
NY,Alfred University,2093987,3260034,5739000,11093021,138254000
TX,Howard County Junior College District,1454607,3485538,6129000,11069145,0
PA,Susquehanna University,2191211,3214295,5663000,11068506,173197000
HI,Hawaii Pacific University,1879700,3322635,5866000,11068335,0
PA,Alvernia University,1983784,3298556,5785000,11067340,0
ME,University Of Maine - Augusta,1351526,3537103,6178000,11066629,0
MA,Smith College,2119895,3123009,5513000,10755904,1913253000
IL,Olive-Harvey College,1429900,3488900,6127000,11045800,0
WI,Wisconsin Indianhead Technical College,1505393,3454455,6049000,11008848,0
DC,Trinity Washington University,1960751,3299710,5742000,11002461,0
GA,Georgia Southwestern State University,1848045,3327789,5826000,11001834,0
PR,Atenas College,2067059,3263200,5650000,10980259,0
WA,Bates Technical College,1684098,3335482,5943000,10962580,0
MA,American International College,1970878,3253225,5730000,10954103,0
MN,Saint Olaf College,2167063,3177701,5603000,10947764,0
MI,Lake Michigan College,1133204,3566805,6245000,10945009,0
TN,Union University,1984881,3240309,5712000,10937190,0
TX,Texas Tech University Health Sciences Center,2217206,3124943,5590000,10932149,0
NY,Nazareth College Of Rochester,2117252,3190890,5624000,10932142,71318000
WV,West Virginia State University,1650103,3356005,5908000,10914108,0
MA,Simmons University,2222441,3107695,5540000,10870136,195840000
MI,Hope College,2163878,3146684,5558000,10868562,232249000
WV,West Virginia University - Parkersburg,1753087,3316392,5786000,10855479,0
RI,Bryant University,2160764,3126451,5562000,10849215,184753000
CA,Mendocino College,1309837,3442731,6073000,10825568,0
IL,Kaskaskia College,1449286,3394076,5982000,10825362,0
PR,American University Of Puerto Rico,1861065,3275786,5673000,10809851,0
MO,Missouri Baptist University,1567808,3332982,5902000,10802790,0
IL,Kishwaukee College,1545526,3355410,5901000,10801936,0
WY,Laramie County Community College,1502654,3360314,5932000,10794968,0
IA,Saint Ambrose University,2054932,3163850,5573000,10791782,0
FL,Florida Gateway College,1498341,3377996,5915000,10791337,17831000
MP,Northern Marianas College,1839331,3274565,5675000,10788896,0
NJ,Caldwell University,2028129,3184209,5567000,10779338,0
NY,American Musical & Dramatic Academy,2278035,3091878,5389000,10758913,0
LA,Central Louisiana Technical Community College,1462721,3372323,5911000,10746044,0
WI,Mid-State Technical College,1528012,3350674,5860000,10738686,0
NH,New England College,1554133,3460812,5676000,10690945,14646000
AL,Chattahoochee Valley Community College,1645716,3294681,5734000,10674397,0
PA,Messiah College,2106740,3089265,5460000,10656005,141904000
NC,Robeson Community College,1637622,3285022,5722000,10644644,0
VA,Shenandoah University,2040202,3089197,5503000,10632399,68105000
TN,Dyersburg State Community College,1495222,3316095,5797000,10608317,0
NC,Lenoir-Rhyne University,1941090,3141073,5523000,10605163,0
MA,Cape Cod Community College,1440010,3325139,5837000,10602149,0
IL,University Of Illinois At Springfield,1731887,3201018,5637000,10569905,0
OH,Tiffin University,1977210,3108766,5453000,10538976,0
WV,Blue Ridge Community And Technical College,1185596,3363953,5989000,10538549,0
IN,University Of Saint Francis,1891129,3141501,5499000,10531630,0
WA,Centralia College,1477765,3276103,5767000,10520868,0
PA,Moravian College,2025895,3071936,5401000,10498831,0
IL,Augustana College,2091818,3038896,5347000,10477714,172846000
MA,Curry College,1934414,3097788,5445000,10477202,103667000
IL,Richland Community College,1365509,3306518,5795000,10467027,0
OK,Tulsa Technology Center School District No. 18,1717200,3155311,5594000,10466511,0
PA,Marywood University,2020450,3048348,5366000,10434798,40574000
MD,"University Of Maryland, Baltimore",2077903,2965115,5384000,10427018,0
TX,Jarvis Christian College,1888040,3124313,5410000,10422353,0
TX,Hardin-Simmons University,1934006,3072013,5385000,10391019,194708000
MN,Concordia University - Saint Paul,1588736,3186977,5604000,10379713,0
NY,Keuka College,1981704,3051019,5325000,10357723,0
VA,University Of Lynchburg,1975980,3024446,5335000,10335426,112879000
PA,Desales University,1846942,3064499,5418000,10329441,91841000
TN,Cumberland University,1920642,3052125,5353000,10325767,0
CA,Brandman University,1196618,3322586,5801000,10320204,0
IL,Illinois Valley Community College,1373121,3234228,5690000,10297349,0
VI,University Of The Virgin Islands,1713737,3121047,5446000,10280784,71684000
NY,Bard College,2064786,2969456,5227000,10261242,0
PA,Mansfield University Of Pennsylvania,1932117,3032041,5279000,10243158,0
IL,Midwestern University,2255126,2802472,5180000,10237598,170498000
TX,Texas Wesleyan University,1857910,3043923,5334000,10235833,59523000
VT,Castleton University,1756834,3074340,5400000,10231174,0
SD,Southeast Technical Institute,1770458,3069293,5389000,10228751,0
MN,Gustavus Adolphus College,2036930,2975740,5215000,10227670,203365000
NM,Western New Mexico University,1551426,3145154,5512000,10208580,0
IL,Wheaton College,2023744,2958197,5225000,10206941,503366000
GU,Guam Community College,1149350,3303441,5747000,10199791,0
NC,Gardner - Webb University,1825407,3022376,5352000,10199783,0
LA,L. E. Fletcher Technical Community College,1375120,3215401,5608000,10198521,0
NM,New Mexico Highlands University,1699974,3085628,5407000,10192602,0
WA,Perry Technical Institute,1967635,2986793,5234000,10188428,0
TN,Trevecca Nazarene University,1718898,3063682,5401000,10183580,0
IL,Moody Bible Institute,1848490,3020458,5296000,10164948,0
FL,Lynn University,1935875,2968610,5244000,10148485,0
VA,Patrick Henry Community College,1483723,3155816,5507000,10146539,0
PA,Harcum College,1774344,3057654,5310000,10141998,0
NY,Nyack College,1773064,3041063,5318000,10132127,0
OK,Oklahoma Baptist University,1934138,2980341,5209000,10123479,130508000
TX,University Of Texas Health Science Center At Houston,1995703,2893112,5228000,10116815,0
PA,Kings College,1968517,2948842,5192000,10109359,0
VT,Middlebury College,1862094,2947241,5283000,10092335,1157786000
NC,Craven Community College,1509343,3112898,5451000,10073241,0
WA,Lake Washington Institute Of Technology,1558088,3070557,5440000,10068645,0
NY,Daemen College,1872946,2971689,5221000,10065635,0
PA,Neumann University,1758118,3015010,5285000,10058128,0
NM,Navajo Technical University,1503703,3109240,5439000,10051943,0
IL,Illinois Eastern Community Colleges - Olney Central College,737002,6578576,2723000,10038578,0
PA,Delaware Valley University,1867829,2963697,5203000,10034526,33623000
TX,Northeast Texas Community College,1140273,3231497,5655000,10026770,0
VA,Mountain Empire Community College,1394924,3133357,5473000,10001281,0
SD,Black Hills State University,1514973,3069733,5415000,9999706,0
NY,D'Youville College,1773370,2969354,5240000,9982724,0
TX,Panola College,1507332,3083051,5387000,9977383,0
MO,Evangel University,1850723,2955736,5167000,9973459,0
OK,Southern Nazarene University,1815175,2957714,5179000,9951889,0
AL,Lurleen B. Wallace Community College,1546138,3063215,5342000,9951353,0
WI,Moraine Park Technical College,1215286,3149222,5584000,9948508,0
IA,Grand View University,1805328,2955616,5164000,9924944,25734000
NY,Suny Fulton-Montgomery Community College,1635420,3014275,5268000,9917695,0
OH,North Central State College,1410128,3087374,5415000,9912502,0
PA,Cabrini University,2005185,2866887,5026000,9898072,0
NY,Mount Saint Mary College,1809886,2927444,5135000,9872330,5998000
CA,College Of Alameda,1049170,3172271,5642000,9863441,0
SD,Lake Area Technical Institute,1768161,2943424,5150000,9861585,0
MA,Clark University,1940791,2852424,5055000,9848215,438767000
MA,Wellesley College,1970468,2841471,5011000,9822939,2173415000
KY,Hazard Community And Technical College,1248333,3109690,5451000,9809023,0
IL,Concordia University,1875573,3094265,5470000,10439838,88859000
MD,Allegany College Of Maryland,1494165,3023670,5283000,9800835,0
NC,Vance - Granville Community College,1453645,3033363,5310000,9797008,0
NY,Herkimer County Community College - Suny Office Of Community Colleges,1522074,3009187,5264000,9795261,0
VA,Virginia Highlands Community College,1398769,3055930,5335000,9789699,0
MN,Northland Community And Technical College,1355409,3053777,5361000,9770186,0
NM,Santa Fe Community College,1219106,3085414,5457000,9761520,0
OH,University Of Rio Grande,1717045,2931560,5112000,9760605,0
AR,Black River Technical College,1643629,2961823,5154000,9759452,0
CA,Whittier College,1879550,2866302,5011000,9756852,112868000
MN,Saint Mary'S University Of Minnesota,1661096,2884483,5163000,9708579,61788000
NC,Surry Community College,1433250,3021468,5245000,9699718,0
AR,Arkansas State University - Newport,1266638,3055614,5377000,9699252,0
IL,Saint Augustine College,1496982,3001085,5201000,9699067,0
GA,Piedmont College,1766322,2872263,5060000,9698585,0
MI,Southwestern Michigan College,1522115,2956093,5166000,9644208,0
ME,Eastern Maine Community College,1426773,2974826,5230000,9631599,0
MA,College Of The Holy Cross,1919146,2750691,4939000,9608837,785852000
NJ,Georgian Court University,1690335,2873205,5041000,9604540,54858000
NC,Nash Community College,1299061,3007699,5276000,9582760,0
OH,Walsh University,1831514,2803207,4933000,9567721,0
MI,Siena Heights University,1545879,2914880,5095000,9555759,0
CT,Middlesex Community College,1323379,2987020,5242000,9552399,0
WI,Alverno College,1738517,2843337,4957000,9538854,0
PA,Bucknell University,1946454,2725476,4863000,9534930,866835000
TX,Texas A & M University - Texarkana,1525001,2916364,5093000,9534365,0
NC,Mitchell Community College,1393025,2950186,5181000,9524211,0
CA,Copper Mountain College,1372962,2973281,5176000,9522243,0
NY,Ulster County Community College,1387075,2929602,5170000,9486677,0
FL,Edward Waters College,1361209,2936739,5183000,9480948,0
NY,Vassar College,1835621,2768070,4871000,9474691,1117380000
CA,Loma Linda University,1777517,2743699,4927000,9448216,1076898000
FL,Full Sail University,9445834,0,0,9445834,0
WY,Casper College,1370012,2913330,5146000,9429342,0
MI,Lake Superior State University,1602263,2845606,4978000,9425869,0
HI,University Of Hawaii - West Oahu,1395000,2916448,5112000,9423448,0
MN,Dakota County Technical College,1467178,2887495,5068000,9422673,0
AL,Oakwood University,1573749,2860345,4984000,9418094,0
TX,Huston - Tillotson University,1630192,2823993,4953000,9407185,0
OH,Edison State Community College,1229604,2956649,5208000,9394253,0
NY,Sage Colleges,1712646,2784805,4895000,9392451,38937000
PA,Thaddeus Stevens College Of Technology,1866667,2740187,4771000,9377854,0
NH,Manchester Community College,1203670,2953061,5218000,9374731,0
CO,Adams State University,1568914,2825647,4959000,9353561,0
OK,Northwestern Oklahoma State University,1506494,2857219,4988000,9351713,0
AZ,Universal Technical Institute,9330780,0,0,9330780,0
NY,Metropolitan College Of New York,1690962,2786721,4850000,9327683,0
MI,Albion College,1831231,2729884,4760000,9321115,161113000
AZ,Dine College,1346931,2909862,5060000,9316793,0
PA,Harrisburg University Of Science And Technology,1536586,2772298,5006000,9314884,0
CA,Canada College,1098544,2937222,5275000,9310766,0
PA,Gwynedd Mercy University,1673075,2765755,4871000,9309830,0
WV,Southern West Virginia Community And Technical College,1523218,2843370,4938000,9304588,0
PA,University Of The Arts (The),1825665,2708958,4751000,9285623,0
CA,Concordia University,1723598,2726592,4831000,9281190,88859000
WI,Lakeland University,1361111,2874606,5043000,9278717,17731000
MI,Adrian College,1752186,2735888,4783000,9271074,0
MT,Montana Technological University,1676199,2747518,4835000,9258717,0
WA,Big Bend Community College,1473837,2822644,4950000,9246481,0
OH,Southern State Community College,1319577,2875872,5048000,9243449,0
NV,Western Nevada College,1363469,2850200,5011000,9224669,0
MI,Madonna University,1517426,2793087,4913000,9223513,0
IL,University Of St. Francis,1539673,2768175,4901000,9208848,20877000
OH,James A. Rhodes State College,1292073,2860797,5054000,9206870,0
WY,Northern Wyoming Community College District,1175360,2886992,5129000,9191352,0
MA,Bay Path University,1431166,2817463,4941000,9189629,0
AR,North Arkansas College,1444804,2820340,4913000,9178144,0
KY,Madisonville Community College,1069051,2936703,5168000,9173754,0
KY,Galen Health Institutes,9167121,0,0,9167121,0
MN,Riverland Community College,1272243,2860474,5030000,9162717,0
KY,University Of Pikeville,1566531,2756839,4838000,9161370,0
NY,St. Lawrence University,1808349,2660768,4691000,9160117,315661000
NY,Dominican College Of Blauvelt,1684221,2710969,4748000,9143190,0
OR,Lewis & Clark College,1827087,2625573,4680000,9132660,246794000
TX,Texas A&M University - Central Texas,1318324,2845060,4969000,9132384,0
PA,Community College Of Beaver County,1381963,2813941,4924000,9119904,0
WV,Glenville State College,1440768,2802178,4876000,9118946,0
KY,Kentucky State University,1372077,2817902,4926000,9115979,0
SC,Technical College Of The Lowcountry - Beaufort Campus,1283989,2850584,4980000,9114573,0
VA,Bridgewater College,1799980,2653699,4645000,9098679,95758000
OH,Muskingum University,1596789,2723866,4776000,9096655,79461000
MI,Spring Arbor University,1581268,2713148,4785000,9079416,19244000
TN,Lemoyne - Owen College,1660276,2713735,4700000,9074011,0
MI,Monroe County Community College,1300516,2818764,4951000,9070280,0
NY,Manhattanville College,1721825,2659835,4686000,9067660,31170000
NC,Guilford College,1682787,2684520,4697000,9064307,78308000
IL,Mckendree University,1636302,2686549,4713000,9035851,0
NJ,Drew University,1727427,2639701,4646000,9013128,183108000
NC,Wilkes Community College,1401082,2753588,4824000,8978670,0
IN,Marian University,1805271,2899595,4269000,8973866,0
PA,Allegheny College,1743082,2629976,4598000,8971058,230453000
VA,Roanoke College,1777599,2551224,4628000,8956823,148794000
AL,George Corley Wallace State Community College - Selma,1298325,2786974,4847000,8932299,0
AZ,Collegeamerica - Flagstaff,1792797,2524521,4612000,8929318,0
AS,American Samoa Community College,1617885,2669776,4638000,8925661,0
ME,University Of New England,1365831,2688237,4871000,8925068,39304000
NY,Boricua College,1744981,2622688,4550000,8917669,0
FL,Saint Thomas University,1296380,2737055,4874000,8907435,0
WI,University Of Wisconsin - Superior,1488367,2694797,4723000,8906164,0
OH,Denison University,1766023,2541005,4598000,8905028,877592000
OH,Franciscan University Of Steubenville,1604718,2635646,4659000,8899364,0
TN,Christian Brothers University,1600690,2647314,4641000,8889004,0
AZ,Coconino County Community College,1104730,2805311,4970000,8880041,0
TX,Lamar State College - Port Arthur,1056684,2846257,4975000,8877941,0
NY,Bryant & Stratton College,8877497,0,0,8877497,0
TX,Universal Technical Institute,8848799,0,0,8848799,0
TX,Brazosport College,1228723,2738926,4874000,8841649,0
GA,Southeastern Technical College,1258784,2759696,4811000,8829480,0
TX,Concordia University Texas,1512530,2657370,4658000,8827900,0
FL,City College,1316096,2746762,4764000,8826858,0
CA,Cerro Coso Community College,908958,2844359,5069000,8822317,0
MD,Mount Saint Mary'S University,1678019,2584181,4555000,8817200,0
NY,Marymount Manhattan College,1701441,2575254,4517000,8793695,0
HI,Chaminade University Of Honolulu,1482800,2653900,4649000,8785700,23399000
NC,Edgecombe Community College,1239795,2752568,4793000,8785363,0
MA,Emmanuel College,1651975,2584736,4547000,8783711,151725000
NM,Clovis Community College,857725,2390522,5532000,8780247,0
DC,Gallaudet University,1642996,2601481,4528000,8772477,188190000
OH,Wittenberg University,1728770,2558869,4484000,8771639,119174000
SC,Limestone College,1350503,2699581,4702000,8752084,0
MA,Becker College,1645170,2580575,4514000,8739745,0
WV,Bridgevalley Community And Technical College,1445025,2659232,4634000,8738257,0
AR,Shorter College,1097484,2773066,4862000,8732550,0
CT,Asnuntuck Community College,1215438,2735540,4770000,8720978,0
PR,University Of Puerto Rico - Utuado,1600359,2606099,4514000,8720458,0
SD,Oglala Lakota College,1297595,2709233,4712000,8718828,0
NY,Suny College Of Environment Science & Forestry,1681739,2550924,4483000,8715663,0
NE,Nebraska Wesleyan University,1382752,2644968,4687000,8714720,0
IL,John Wood Community College,1245792,2717630,4749000,8712422,0
IL,Rend Lake College,1182264,2719542,4804000,8705806,0
MD,Mcdaniel College,1629536,2549733,4498000,8677269,134764000
ND,University Of Mary,1536188,2560792,4551000,8647980,55479000
TX,Galveston College,1212226,2698376,4735000,8645602,0
WA,Grays Harbor College,1303394,2671568,4669000,8643962,0
IA,North Iowa Area Community College,1293311,2656684,4684000,8633995,32433000
NC,Mars Hill University,1707699,2527689,4395000,8630388,0
KS,Cowley County Community College & Area Vocational Technical School,1206714,2692584,4723000,8622298,0
MS,Rust College,1359587,2646031,4615000,8620618,43445000
IN,University Of Evansville,1681651,2503846,4416000,8601497,85667000
TX,East Texas Baptist University,1556715,2563621,4475000,8595336,0
NC,Blue Ridge Community College,1426892,2598523,4562000,8587415,9499000
NC,Cleveland Community College,1214574,2678304,4691000,8583878,0
TX,Wiley College,1538638,2577092,4468000,8583730,0
PA,Keystone College,1425853,2577532,4574000,8577385,0
MI,Cornerstone University,1514292,2564593,4495000,8573885,10434000
TN,Tennessee College Of Applied Technology-Memphis,1453214,2595530,4522000,8570744,0
WV,Pierpont Community & Technical College,1154797,2698353,4712000,8565150,0
VA,Ferrum College,1673615,2516615,4370000,8560230,53517000
MA,Babson College,1761990,2433726,4362000,8557716,457670000
NC,Randolph Community College,1264255,2648434,4637000,8549689,0
HI,University Of Hawaii Maui College,1187907,2668102,4689000,8545009,0
OR,Eastern Oregon University,1158327,2679451,4700000,8537778,0
MA,Lasell University,1647941,2497307,4391000,8536248,45910000
AL,Snead State Community College,1239198,2642522,4633000,8514720,0
SC,Newberry College,1592676,2521835,4391000,8505511,0
VT,Champlain College,1368260,2577443,4549000,8494703,0
IL,Danville Area Community College,942073,2719814,4817000,8478887,0
PA,Chestnut Hill College,1574651,2503187,4378000,8455838,0
GA,Life University,1677181,2440082,4338000,8455263,0
DE,Wesley College,1494069,2536920,4418000,8448989,0
IL,Carl Sandburg College,1175052,2636911,4608000,8419963,0
PA,Franklin & Marshall College,1692121,2412793,4308000,8412914,354783000
NE,Doane University,1538922,2483317,4387000,8409239,113944000
NC,Queens University Of Charlotte,1532289,2483916,4379000,8395205,150237000
VA,Wytheville Community College,1217475,2607176,4569000,8393651,0
MD,Goucher College,1575324,2465931,4340000,8381255,203430000
RI,Salve Regina University,1715409,2407367,4251000,8373776,63790000
NY,St. Bonaventure University,1592629,2450106,4316000,8358735,74402000
NY,Barnard College,1712643,2395232,4239000,8346875,363623000
TN,King University,1405253,2586230,4349000,8340483,0
KS,Barton County Community College,896181,2662852,4773000,8332033,0
NC,Meredith College,1674515,2411617,4229000,8315132,114786000
TX,Trinity University,1665507,2394160,4239000,8298667,1280248000
KY,Thomas More University,1329216,2520355,4430000,8279571,0
PA,Misericordia University,1536398,2440041,4303000,8279439,54532000
SC,Furman University,1656467,2378551,4229000,8264018,694272000
PA,Gettysburg College,1656033,2384833,4223000,8263866,330714000
CO,Western Colorado University,1353339,2489853,4420000,8263192,0
AL,Enterprise State Community College,1240737,2555815,4465000,8261552,0
OR,Umpqua Community College,1121853,2593396,4533000,8248249,0
MI,Northwood University,1358224,2497291,4391000,8246515,97869000
HI,Hawaii Community College,1147226,2574000,4510000,8231226,0
MD,Fortis Institute - Towson,8227327,0,0,8227327,0
VA,Rappahannock Community College,1149192,2564530,4513000,8226722,0
HI,Honolulu Community College,1107387,2568029,4547000,8222416,0
MA,Massachusetts College Of Art And Design,1510265,2432464,4278000,8220729,0
VA,Virginia Wesleyan University,1493207,2448369,4276000,8217576,0
OK,Oklahoma Christian University,1619172,2388752,4208000,8215924,0
MN,Minnesota West Community And Technical College,1072094,2583493,4551000,8206587,0
PA,Lancaster Bible College,1389655,2477282,4338000,8204937,0
NY,Colgate University,1636002,2361476,4202000,8199478,950360000
AR,Southeast Arkansas College,1187530,2560591,4450000,8198121,0
GA,Brenau University,1283197,2507744,4393000,8183941,49482000
KS,Garden City Community College,1282005,2506940,4387000,8175945,0
MA,Mount Holyoke College,1588803,2374484,4193000,8156287,794204000
IA,Southeastern Community College,1155058,2539510,4456000,8150568,0
KS,Coffeyville Community College,1219871,2519186,4411000,8150057,0
WI,Saint Norbert College,1595105,2367509,4173000,8135614,0
WI,Lakeshore Technical College,977816,2597047,4559000,8133863,0
NY,Skidmore College,1640633,2340853,4152000,8133486,384280000
CA,William Jessup University,1486736,2407561,4232000,8126297,0
MS,Tougaloo College,1487317,2310909,4325000,8123226,0
MN,Concordia College - Moorhead,1590356,2360701,4166000,8117057,0
PR,Albizu University,1453598,2398440,4264000,8116038,0
OH,Ohio Wesleyan University,1602505,2341490,4168000,8111995,243083000
MA,Williams College,1564588,2369232,4174000,8107820,2888962000
FL,Webber International University,1470540,2417415,4209000,8096955,0
IN,Grace College And Theological Seminary,1551701,2375929,4169000,8096630,0
GA,Oconee Fall Line Technical College,1152438,2527282,4402000,8081720,0
IL,Lake Forest College,1546268,2375182,4160000,8081450,90630000
TN,Tusculum University,1493995,2397431,4187000,8078426,0
IN,Anderson University,1564159,2367509,4145000,8076668,0
IN,Indiana University - East,1062722,2538074,4457000,8057796,0
UT,Lds Business College,1422523,2392206,4212000,8026729,0
NC,Southwestern Community College,1187630,2482510,4349000,8019140,0
PA,Muhlenberg College,1619907,2258253,4138000,8016160,288974000
OH,Franklin University,846988,2889785,4275000,8011773,93156000
IL,Chamberlain University,8007329,0,0,8007329,0
WV,Mountwest Community And Technical College,1129207,2495734,4372000,7996941,0
PA,Carlow University,1343715,2413761,4229000,7986476,0
IA,William Penn University,1485340,2371372,4129000,7985712,0
GA,Berry College,1589811,2313835,4079000,7982646,1058605000
MI,Lawrence Technological University,1462382,2348383,4154000,7964765,0
PA,Saint Vincent College & Seminary,1605435,2296210,4036000,7937645,0
OK,Oklahoma City University,1536667,2303854,4097000,7937521,0
IL,Lincoln College,1279507,2432172,4221000,7932679,0
NY,Hobart And William Smith Colleges,1571579,2298243,4052000,7921822,229107000
OH,Mount Vernon Nazarene University,1330478,2390828,4194000,7915306,0
TX,Lubbock Christian University,1422450,2357712,4130000,7910162,22015000
OH,Wilmington College,1514460,2330038,4062000,7906498,0
SC,Morris College,1481212,2350669,4070000,7901881,0
MA,Amherst College,1574582,2283237,4012000,7869819,2473283000
OK,Murray State College,1167810,2437012,4258000,7862822,0
PA,Cedar Crest College,1526417,2304150,4030000,7860567,36651000
IN,Depauw University,1574528,2253903,4007000,7835431,730341000
LA,Northwest Louisiana Technical Community College,1136669,2440885,4244000,7821554,0
FL,Chipola College,1208491,2398117,4202000,7808608,0
PR,Universal Technology College Of Puerto Rico,1432599,2252260,4117000,7801859,0
CA,Columbia College Hollywood,1405837,2109386,4285000,7800223,0
FL,Eckerd College,1561944,2238201,3999000,7799145,60579000
OR,Treasure Valley Community College,997664,2464882,4327000,7789546,0
TX,University Of Texas Health Science Center At San Antonio,1545801,2223504,4000000,7769305,0
AL,Central Alabama Community College,1222052,2380348,4163000,7765400,0
NC,Western Piedmont Community College,1157050,2272532,4328000,7757582,0
AR,University Of Arkansas Community College At Hope-Texarkana,1156335,2407209,4192000,7755544,0
MN,College Of Saint Benedict,1572552,2204200,3966000,7742752,83506000
MO,Avila University,1391760,2287906,4059000,7738666,0
CA,Downey Adult School,1232716,2288989,4214000,7735705,0
MO,Missouri Valley College,1322917,2331466,4076000,7730383,0
NJ,Sussex County Community College,1156835,2381665,4191000,7729500,0
SD,South Dakota School Of Mines & Technology,1455698,2264943,4008000,7728641,65076000
GA,South University,7726176,0,0,7726176,0
SC,Allen University,1589675,2243073,3885000,7717748,0
CT,Albertus Magnus College,1362920,2304400,4023000,7690320,0
GA,Point University,1214025,2353229,4121000,7688254,64777000
IA,Coe College,1525647,2234501,3928000,7688148,0
OK,Francis Tuttle Technology Center School District No. 21,1347306,2237088,4095000,7679394,0
ND,Minot State University,1275782,2315110,4083000,7673892,0
NC,Saint Augustine'S University,1450038,2276686,3945000,7671724,0
TX,Southwestern Assemblies Of God University,1215532,2351126,4103000,7669658,0
NC,Southeastern Community College,1118302,2082781,4456000,7657083,0
NY,Trocaire College,1147253,2372371,4130000,7649624,0
PA,Seton Hill University,1266845,2298815,4079000,7644660,0
ME,Kennebec Valley Community College,979695,2418076,4239000,7636771,0
PR,Mech Tech College,7627631,0,0,7627631,0
IN,Manchester University,1511452,2188041,3927000,7626493,64470000
NC,Belmont Abbey College,1407500,2247933,3933000,7588433,0
MA,Assumption College,1485031,2203031,3898000,7586062,102942000
MD,Carroll Community College,1104882,2336256,4137000,7578138,0
TX,Texas Lutheran University,1408194,2237611,3910000,7555805,94530000
OR,Linfield College,1441325,2218297,3895000,7554622,108080000
PA,Saint Francis University,1409610,2214219,3927000,7550829,52713000
OK,Seminole State College,1163326,2326059,4060000,7549385,0
CA,Columbia College,994576,2374255,4172000,7540831,168869000
WA,Walla Walla University,1437520,2200713,3879000,7517233,28836000
OR,Southwestern Oregon Community College,1081690,2334480,4095000,7511170,0
MO,State Technical College Of Missouri,1364179,2233682,3910000,7507861,0
WV,Bluefield State College,1296174,2258274,3928000,7482448,0
NY,Concordia College,813395,2487042,4166000,7466437,143479000
FL,Erwin Technical College,967210,2355228,4143000,7465438,0
MA,Stonehill College,1498782,2143106,3820000,7461888,217240000
WV,University Of Charleston,1222988,2258339,3970000,7451327,0
WA,Peninsula College,1160439,2285928,4004000,7450367,0
MI,Kettering University,1457033,2156693,3836000,7449726,90353000
MI,Andrews University,1236555,2227235,3980000,7443790,0
PA,University Of The Sciences In Philadelphia,1475914,2059170,3905000,7440084,162527000
NC,Catawba College,1407154,2191691,3826000,7424845,0
OH,Notre Dame College Of Ohio,1274119,2238457,3912000,7424576,0
PA,Waynesburg University,1442703,2164737,3813000,7420440,0
MN,Macalester College,1483970,2141894,3790000,7415864,770782000
AL,Stillman College,1206208,2281898,3926000,7414106,0
MD,Cecil College,1115623,2282889,4015000,7413512,0
MO,Rockhurst University,1169737,2786245,3455000,7410982,36471000
WI,Marian University,1147099,1984559,4269000,7400658,0
OR,Willamette University,1509234,2123316,3761000,7393550,262124000
NY,Roberts Wesleyan College,1381405,2180388,3830000,7391793,0
NH,Franklin Pierce University,1400647,2169855,3819000,7389502,0
MN,University Of Minnesota - Morris,1434554,2163039,3789000,7386593,0
MA,Massachusetts College Of Liberal Arts,1309397,2202852,3859000,7371249,13544000
IA,Simpson College,1453050,2148524,3760000,7361574,0
PA,Lebanon Valley College,1442705,2135202,3781000,7358907,71832000
OH,Oberlin College,1457347,2088700,3805000,7351047,943469000
PA,Lycoming College,1392658,2156676,3796000,7345334,0
NY,Stella And Charles Guttman Community College,1228352,2231778,3872000,7332130,0
OH,Northwest State Community College,962933,2284428,4075000,7322361,0
WI,Edgewood College,1402919,2142831,3774000,7319750,0
KS,Midamerica Nazarene University,1199713,2212640,3907000,7319353,0
CA,Occidental College,1474674,2114553,3730000,7319227,448095000
NJ,Centenary University,1350523,2161482,3792000,7304005,7330000
MN,Anoka Technical College,1108759,2251405,3943000,7303164,0
AL,University Of Mobile,1257422,2193784,3843000,7294206,0
AR,Ouachita Baptist University,1344385,2155889,3781000,7281274,0
IA,Mount Mercy University,1221083,2194529,3863000,7278612,0
CA,Coastline Community College,634209,2394934,4249000,7278143,0
KS,Benedictine College,1420495,2118571,3737000,7276066,0
NM,New Mexico Junior College,1121004,2230402,3923000,7274406,0
RI,Rhode Island School Of Design,1464915,2090083,3711000,7265998,349660000
AR,John Brown University,1316339,2154561,3794000,7264900,125570000
MI,Alma College,1429939,2083777,3744000,7257716,0
WA,University Of Puget Sound,1418056,2104744,3733000,7255800,380507000
NY,Wagner College,1488258,2079612,3679000,7246870,77564000
AR,Arkansas State University - Mountain Home,1059570,2253796,3926000,7239366,0
NY,North Country Community College,1111281,2219613,3887000,7217894,0
GA,Reinhardt University,1278399,2157472,3768000,7203871,0
NM,New Mexico Institute Of Mining & Technology,1353197,2121204,3727000,7201401,0
MA,Berkshire Community College,1052143,2232738,3904000,7188881,0
IL,Midwest Technical Institute,7164512,0,0,7164512,0
IA,Buena Vista University,1123792,2192341,3827000,7143133,136568000
KS,Highland Community College,967270,2315079,3852000,7134349,0
MI,Olivet College,1315786,2121989,3695000,7132775,0
OH,College Of Wooster (The),1417795,2064878,3647000,7129673,0
WA,Saint Martin'S University,1252197,2133004,3738000,7123201,0
MN,Dunwoody College Of Technology,1304369,2117843,3698000,7120212,0
TX,Ranger College,1047733,2201022,3868000,7116755,0
TX,Lamar State College - Orange,1043319,2206109,3865000,7114428,0
PA,Dickinson College,1436068,2030560,3640000,7106628,455442000
KS,Fort Scott Community College,1021526,2205875,3868000,7095401,0
IL,Judson University,1311084,2103474,3673000,7087558,0
GA,Oglethorpe University,1279508,2105854,3687000,7072362,0
NC,Louisburg College,1342704,2097680,3630000,7070384,0
IA,Luther College,1380684,2050589,3621000,7052273,168780000
WI,Viterbo University,1279908,2082039,3687000,7048947,55673000
MA,College Of Our Lady Of The Elms,1298135,2089016,3658000,7045151,0
PR,Universidad Central De Bayamon,958454,2224465,3862000,7044919,0
OH,Mount St. Joseph University,1282973,2083359,3675000,7041332,0
NC,Pfeiffer University,1274850,2087406,3678000,7040256,0
SC,Converse College,1326683,2068714,3644000,7039397,78372000
GA,Shorter University,1208080,2118322,3696000,7022402,0
TN,Freed Hardeman University,1353998,2051737,3614000,7019735,0
AR,South Arkansas Community College,1071512,2161063,3772000,7004575,0
AL,Spring Hill College,1372682,2046512,3581000,7000194,24768000
IN,Bethel University,1269847,2081394,3638000,6989241,0
SC,Spartanburg Methodist College,1322353,2070489,3595000,6987842,22069000
VA,Southern Virginia University,1257205,2088697,3635000,6980902,0
NC,Lenoir Community College,970886,2181419,3827000,6979305,0
TN,Tennessee College Of Applied Technology - Nashville,1038538,1970898,3960000,6969436,0
SC,Columbia College,1002296,1793174,3128000,5923470,168869000
NY,Suny Maritime College,1400241,1977394,3582000,6959635,0
IL,Highland Community College,911809,2194108,3852000,6957917,0
FL,Hodges University,1029439,2162207,3763000,6954646,0
ID,College Of Eastern Idaho,985694,2172759,3793000,6951453,0
TN,Maryville College,1401887,2010056,3507000,6918943,0
IA,Graceland University,1147199,2070241,3696000,6913440,0
PA,Elizabethtown College,1350544,2012838,3546000,6909382,83797000
NY,Be'Er Yaakov Talmudic Seminary,1335069,2035253,3524000,6894322,0
WA,Heritage University,1283643,2046489,3564000,6894132,0
PA,Lafayette College,1391019,1970926,3521000,6882945,832068000
MN,University Of Northwestern- St Paul,1138110,2064141,3674000,6876251,0
CA,California College Of The Arts,1397586,1980370,3496000,6873956,36040000
WA,Cascadia College,1156230,2051497,3665000,6872727,0
OH,Malone University,1247915,2039528,3579000,6866443,0
FL,Sheridan Technical College,1063091,2103860,3694000,6860951,0
NC,Sampson Community College,1033931,2114437,3705000,6853368,0
TX,University Of Dallas,1277096,2011032,3556000,6844128,0
TX,College Of Health Care Professions (The),6835962,0,0,6835962,0
MA,Gordon College,1311252,1994086,3525000,6830338,0
MD,Maryland Institute College Of Art,1318621,1985633,3520000,6824254,94441000
WA,Charter College,6816451,0,0,6816451,0
CT,Trinity College,1376444,1953790,3479000,6809234,623153000
IL,Illinois Wesleyan University,1341680,1982260,3484000,6807940,206191000
KS,Baker University,1134284,2045379,3617000,6796663,0
MD,Chesapeake College,917533,2135148,3742000,6794681,0
NC,South Piedmont Community College,977809,2100498,3704000,6782307,0
MD,Hood College,1265284,1998556,3517000,6780840,106905000
IL,Knox College,1328070,1982465,3466000,6776535,170174000
AR,University Of Arkansas Community College At Batesville,1029926,2093350,3648000,6771276,0
CA,Woodbury University,1199479,2029312,3542000,6770791,0
MA,Wheaton College,1338514,1935305,3480000,6753819,503366000
OH,Lourdes University,1108640,2044801,3600000,6753441,0
MN,Saint John'S University,1357136,1933994,3460000,6751130,208738000
MN,Summit Academy Opportunities Industrialization Center,1272165,1905539,3560000,6737704,0
UT,Westminster College,1897239,2895045,5092000,9884284,116515000
CO,Trinidad State Junior College,1038406,2068234,3622000,6728640,0
AL,Athens State University,845033,2140301,3741000,6726334,0
NY,Sullivan County Community College - Suny Office Of Community Colleges,1038982,2053779,3632000,6724761,0
NC,Isothermal Community College,1012055,2073934,3632000,6717989,0
TX,Mcmurry University,1136612,2031666,3540000,6708278,94536000
VA,Mary Baldwin University,1120685,2033234,3554000,6707919,30179000
WA,Northwest University,1075562,2038034,3582000,6695596,0
FL,Ringling College Of Art And Design,1273220,1966822,3448000,6688042,53537000
MO,Missouri State University - West Plains,960166,2082884,3643000,6686050,0
PA,Pennsylvania Highlands Community College,880286,2100714,3704000,6685000,0
PA,Geneva College,1347254,1936527,3397000,6680781,0
MT,Flathead Valley Community College,925144,2079030,3673000,6677174,0
OH,Ohio Dominican University,1186525,1991363,3497000,6674888,20161000
TX,Letourneau University,1050372,2033240,3589000,6672612,22055000
PA,Washington And Jefferson College,1334327,1936173,3401000,6671500,0
CA,Dominican University Of California,1244783,1962413,3457000,6664196,0
FL,Adventhealth University,1126242,2008706,3527000,6661948,0
OH,Marion Technical College,953875,2068897,3637000,6659772,0
LA,Louisiana State University Health Sciences Center,1391236,1881142,3381000,6653378,0
AL,Huntingdon College,1225333,1976343,3444000,6645676,0
NE,Chadron State College,1081277,2016084,3541000,6638361,0
OH,Zane State College,1002163,2040434,3590000,6632597,0
VA,Emory & Henry College,1262240,1941855,3396000,6600095,0
AZ,University Of Phoenix,6589433,0,0,6589433,0
MA,Regis College,1025140,2001630,3559000,6585770,0
NY,Hartwick College,1271783,1933993,3377000,6582776,76792000
TX,Hallmark University,1304065,1925928,3348000,6577993,0
TX,Austin College,1342606,1904577,3330000,6577183,149667000
OH,Terra State Community College,852360,2073348,3642000,6567708,0
MA,Nichols College,1236801,1932689,3393000,6562490,17345000
IL,Sauk Valley Community College,926411,2045042,3590000,6561453,0
CT,University Of Saint Joseph,1158343,1948054,3453000,6559397,34781000
PA,La Roche University,1205918,1942542,3401000,6549460,0
IL,Rockford University,1225910,1931238,3382000,6539148,0
TX,Schreiner University,1181201,1944297,3407000,6532498,0
OK,Eastern Oklahoma State College,937568,2035000,3554000,6526568,0
ID,Northwest Nazarene University,820668,2039850,3661000,6521518,0
AR,Phillips Community College Of The University Of Arkansas,905327,2043633,3570000,6518960,0
TN,Baptist Memorial College Of Health Sciences,1141951,1959332,3412000,6513283,0
OR,Blue Mountain Community College,966862,2004616,3527000,6498478,0
CT,Lincoln Technical Institute,6495045,0,0,6495045,0
NH,Great Bay Community College,870169,2028155,3584000,6482324,0
MI,North Central Michigan College,835428,2034633,3605000,6475061,0
MI,Aquinas College,1204512,1910297,3357000,6471809,0
IA,Loras College,1272730,1883667,3307000,6463397,41584000
IA,Wartburg College,1289269,1876934,3297000,6463203,0
MA,Greenfield Community College,887515,2023815,3547000,6458330,0
TX,Paul Quinn College,1163719,1937535,3357000,6458254,0
NJ,Lincoln Technical Institute,6452823,0,0,6452823,0
PA,Westminster College,1265227,1876014,3298000,6439241,116515000
NE,Midland University,1102337,1920489,3403000,6425826,0
LA,Louisiana College,1147506,1920379,3356000,6423885,0
CT,Quinebaug Valley Community College,889048,2015443,3515000,6419491,0
NM,Northern New Mexico College,1051562,1957707,3402000,6411269,0
NE,University Of Nebraska Medical Center,1295673,1817776,3295000,6408449,0
IN,Saint Mary'S College,1201641,1886322,3319000,6406963,201649000
MO,North Central Missouri College,892038,2004717,3509000,6405755,0
KY,Spalding University,1155755,1902707,3346000,6404462,0
UT,Davis Technical College,713275,1890758,3790000,6394033,0
TN,Fisk University,1085474,1829862,3475000,6390336,0
KS,Newman University,993846,1934708,3455000,6383554,0
PA,Chatham University,1162375,1858720,3357000,6378095,94216000
MT,University Of Montana Western (The),1164902,1891743,3310000,6366645,0
CA,Pomona College,1285644,1834733,3243000,6363377,2324594000
IL,Illinois College,1239311,1850025,3271000,6360336,129905000
KY,Union College,1308850,1956695,3416000,6681545,466372000
ME,Colby College,1244996,1803716,3275000,6323712,869927000
WV,West Virginia Wesleyan College,1242558,1847605,3232000,6322163,0
NC,Bladen Community College,861961,1987811,3465000,6314772,0
FL,Florida Polytechnic University,1253303,1838614,3221000,6312917,0
TX,Southern Careers Institute,6305240,0,0,6305240,0
OH,Antioch University,1107211,1813557,3363000,6283768,0
NY,Hamilton College,1189507,1837979,3254000,6281486,969362000
IA,Iowa Lakes Community College,966888,1921737,3389000,6277625,0
NY,Asa College,6272628,0,0,6272628,0
WI,Mount Mary University,1157273,1857770,3250000,6265043,0
NC,College Of The Albemarle,909714,1936881,3411000,6257595,0
TX,Southwestern University,1213449,1828552,3214000,6256001,296413000
SD,Augustana University,1215394,1816774,3213000,6245168,0
KS,Labette Community College,812240,1961626,3471000,6244866,0
NC,Barton College,1161318,1847742,3223000,6232060,0
OH,Heidelberg University,1190956,1831777,3206000,6228733,51987000
IA,Morningside College,1147631,1832741,3232000,6212372,46271000
MI,College For Creative Studies,1136489,1841570,3228000,6206059,0
NY,Houghton College,1272224,1798688,3135000,6205912,57372000
TX,Clarendon College,885687,1913765,3388000,6187452,0
VT,Saint Michael'S College,1186800,1795756,3195000,6177556,89061000
CA,Notre Dame De Namur University,1121450,1836201,3219000,6176651,0
MA,Massachusetts Maritime Academy,1242689,1739892,3177000,6159581,0
MA,Dean College,1087115,1840110,3225000,6152225,0
SD,University Of Sioux Falls,1036173,1853841,3259000,6149014,30327000
KS,Haskell Indian Nations University,1111478,1837814,3195000,6144292,0
OH,Washington State Community College,926232,1892309,3319000,6137541,0
WI,Cardinal Stritch University,1031055,1849327,3256000,6136382,0
FL,Manatee Technical College,1015473,1851459,3253000,6119932,0
SC,Coker University,1147692,1809360,3161000,6118052,45680000
OH,Columbus College Of Art & Design,1168931,1801090,3143000,6113021,0
NC,Rockingham Community College,933713,1876718,3288000,6098431,0
TN,Tennessee Wesleyan University,1192356,1787165,3116000,6095521,0
FL,Warner University,1078101,1829015,3185000,6092116,0
TN,Tennessee College Of Applied Technology - Morristown,877779,1711569,3501000,6090348,0
VA,Averett University,1055659,1828557,3200000,6084216,21268000
MA,Hampshire College,1199199,1776110,3105000,6080309,0
CT,Connecticut College,1202711,1753472,3114000,6070183,313510000
IA,Grinnell College,1190471,1761684,3107000,6059155,2069953000
IL,Trinity Christian College,1067149,1812382,3176000,6055531,0
NC,Davidson College,1220411,1743286,3090000,6053697,881465000
NY,Cuny Graduate School & University Center,776134,1877959,3393000,6047093,0
IN,Taylor University,1073311,1793326,3178000,6044637,98717000
CA,College Of The Siskiyous,785260,1909035,3349000,6043295,0
KS,Friends University,1018077,1814055,3211000,6043132,53324000
OR,Klamath Community College,699314,1932447,3391000,6022761,0
KS,Dodge City Community College,949264,1820945,3251000,6021209,0
ND,Bismarck State College,914066,1834237,3249000,5997303,0
AR,Arkansas State University Mid-South,855413,1869661,3266000,5991074,0
MI,Montcalm Community College,861963,1861770,3259000,5982733,0
CA,Pacific Union College,1138223,1763069,3080000,5981292,0
PA,Swarthmore College,1200865,1729865,3049000,5979730,2131553000
VT,Vermont Technical College,971406,1813509,3186000,5970915,0
GA,Agnes Scott College,1148230,1754874,3063000,5966104,217142000
CO,Northeastern Junior College,868359,1708469,3380000,5956828,0
CO,Otero Junior College,902921,1839224,3213000,5955145,0
WI,Southwest Wisconsin Technical College,783630,1868092,3299000,5950722,0
NY,Union College,1159940,1707070,3033000,5900010,466372000
CA,American Career College,5944572,0,0,5944572,0
WV,Alderson Broaddus University,1126674,1753272,3057000,5936946,0
TN,Rhodes College,1205945,1694962,3027000,5927907,352206000
MD,Saint Mary'S College Of Maryland,1173755,1716025,3027000,5916780,0
NY,Yeshivath Viznitz,1198248,1724833,2993000,5916081,0
NH,Nashua Community College,802358,1845578,3265000,5912936,0
OH,Wilberforce University,689372,1911149,3311000,5911521,0
OH,Hiram College,1033772,1774527,3099000,5907299,0
NY,"Teachers College, Columbia University",1118534,1680289,3107000,5905823,345191000
NH,Saint Anselm College,1134675,1695795,3067000,5897470,164005000
PA,Immaculata University,1006089,1763406,3125000,5894495,0
MI,Kalamazoo College,1178454,1709694,3006000,5894148,240344000
MN,University Of Minnesota - Crookston,864154,1816506,3207000,5887660,0
MN,Carleton College,1168048,1699739,3017000,5884787,892353000
FL,Florida National University,5884598,0,0,5884598,0
FL,Everglades University,776027,1751606,3354000,5881633,0
NY,Columbia - Greene Community College - Suny Office Of Cmnty Colleges,840707,1827663,3203000,5871370,0
TX,University Of Texas Medical Branch At Galveston,1101752,1693386,3055000,5850138,0
PA,Lake Erie College Of Osteopathic Medicine,1233436,1615729,2987000,5836165,0
IL,Shawnee Community College,637619,1880324,3318000,5835943,0
FL,Lively Technical College,942497,1782744,3105000,5830241,0
SD,Dakota State University,771997,1819817,3223000,5814814,226626000
PR,University Of Puerto Rico - Medical Science Campus,1190264,1662218,2962000,5814482,0
KY,Asbury University,1017118,1736565,3046000,5799683,0
CA,Mills College,1135582,1693357,2965000,5793939,196404000
DC,Strayer University,5792122,0,0,5792122,0
FL,Atlantic Technical College,758163,1801531,3225000,5784694,0
WI,Lawrence University Of Wisconsin,1157627,1673315,2953000,5783942,356958000
VA,Richard Bland College,820734,1790616,3163000,5774350,0
NY,Onondaga Cortland Madison Boces,842620,1457826,3470000,5770446,0
KY,Henderson Community College,806658,1807184,3156000,5769842,0
AR,Hendrix College,1056780,1687170,3024000,5767950,200680000
VA,University Of Virginia'S College At Wise (The),788966,1804120,3173000,5766086,0
AZ,Northland Pioneer College,643137,1842485,3280000,5765622,0
PR,Humacao Community College,967546,1755904,3038000,5761450,0
IN,Rose - Hulman Institute Of Technology,1191507,1644105,2924000,5759612,0
SC,Voorhees College,1124053,1695557,2934000,5753610,0
MA,Urban College Of Boston,608706,1874227,3261000,5743933,0
GA,Interactive College Of Technology,5735726,0,0,5735726,0
ME,Bowdoin College,1123660,1657730,2936000,5717390,1743663000
CO,Colorado College,1157391,1638010,2921000,5716401,766910000
MN,North Central University,1046302,1692123,2956000,5694425,0
IL,Resurrection University,1061270,1685149,2942000,5688419,0
MO,Culver-Stockton College,1067399,1676752,2929000,5673151,29467000
NJ,Warren County Community College,686371,1791312,3191000,5668683,0
TN,Tennessee College Of Applied Technology - Knoxville,822349,1739895,3106000,5668244,0
PA,Ursinus College,1149294,1637237,2880000,5666531,131213000
MA,Cambridge College,925862,1702049,3031000,5658911,0
WY,Western Wyoming Community College,725242,1774485,3159000,5658727,0
CA,Cbd College,959316,1713690,2983000,5656006,0
MD,Notre Dame Of Maryland University,969449,1687957,2996000,5653406,35835000
IA,Dordt University,1082435,1654086,2915000,5651521,0
NE,Western Nebraska Community College,805697,1757098,3087000,5649795,0
MT,Salish Kootenai College,832524,1754585,3062000,5649109,0
CA,West Hills Community College,592666,1822336,3224000,5639002,0
CA,Otis College Of Art & Design,1100507,1648794,2887000,5636301,0
IL,Quincy University,1041392,1668907,2924000,5634299,0
AR,Ozarka College,797075,1763049,3069000,5629124,0
NC,Stanly Community College,731366,1777412,3110000,5618778,0
KS,Neosho County Community College,806338,1742066,3070000,5618404,0
NE,Peru State College,827344,1737928,3053000,5618272,0
NE,Concordia University,1017489,1656961,2940000,5614450,88859000
MI,Bay De Noc Community College,778116,1757060,3079000,5614176,0
MT,Great Falls College Montana State University,845222,1730333,3027000,5602555,0
OH,Mercy College Of Ohio,886791,1716262,2996000,5599053,0
TN,Johnson University,997716,1667345,2918000,5583061,0
OH,Collins Career Technical Center,1024753,1439028,3117000,5580781,0
NY,Cazenovia College,1008776,1661084,2903000,5572860,0
AR,East Arkansas Community College,840222,1724373,2992000,5556595,0
VA,Virginia Military Institute,1132691,1565705,2853000,5551396,0
ND,Turtle Mountain Community College,947936,1682904,2920000,5550840,0
NC,Carteret Community College,774946,1556031,3218000,5548977,0
IL,Greenville University,957351,1667764,2919000,5544115,21160000
IL,Trinity International University,903509,1670121,2966000,5539630,0
CT,Northwestern Connecticut Community College,602265,1431434,3501000,5534699,0
GA,Lagrange College,1074446,1622319,2835000,5531765,53005000
TN,University Of The South (The),1094094,1598238,2836000,5528332,0
PA,Juniata College,1082356,1605406,2830000,5517762,120223000
OK,Tulsa Welding School,5505774,0,0,5505774,0
MI,Alpena Community College,759853,1717931,3019000,5496784,0
AR,Cossatot Community College Of The University Of Arkansas,775262,1715171,3003000,5493433,0
PA,Mount Aloysius College,816503,1686780,2984000,5487283,43986000
OR,Oregon Health & Science University,1012193,1597982,2872000,5482175,0
TN,Tennessee College Of Applied Technology - Elizabethton,881164,1549711,3042000,5472875,0
SC,Wofford College,1103905,1561734,2802000,5467639,211673000
NE,College Of Saint Mary,1055309,1602125,2810000,5467434,0
WI,Beloit College,1086370,1588329,2790000,5464699,114121000
SD,Western Dakota Technical Institute,863880,1673430,2920000,5457310,0
TN,Tennessee College Of Applied Technology - Dickson,821613,1517962,3104000,5443575,0
NE,Mid-Plains Community College,774946,1687412,2978000,5440358,0
CA,Master'S University And Seminary (The),936440,1616925,2885000,5438365,0
MN,Alexandria Technical And Community College,807310,1669171,2957000,5433481,0
NC,William Peace University,1006338,1612358,2812000,5430696,50222000
TX,Parker University,970426,1604204,2842000,5416630,0
NJ,College Of Saint Elizabeth,935846,1630679,2850000,5416525,0
OK,Kiamichi Technology Center,1023214,1570953,2817000,5411167,0
CA,Carrington College,5403151,0,0,5403151,0
KS,University Of Saint Mary,976950,1603725,2814000,5394675,0
IN,Hanover College,1065765,1569890,2748000,5383655,146078000
IN,Franklin College Of Indiana,1071874,1562660,2743000,5377534,0
WV,West Virginia Northern Community College,732317,1686844,2952000,5371161,0
CO,Pickens Technical College,839917,1623436,2905000,5368353,0
KS,Cloud County Community College,763297,1667878,2937000,5368175,0
TN,Martin Methodist College,963462,1603235,2794000,5360697,0
IL,Monmouth College,1069404,1561080,2729000,5359484,122619000
VA,Randolph - Macon College,1058238,1556549,2743000,5357787,0
ND,North Dakota State College Of Science,823352,1641417,2889000,5353769,0
AR,University Of The Ozarks,1011314,1582461,2759000,5352775,115068000
DE,Goldey-Beacom College,1040019,1561354,2747000,5348373,0
MT,Montana State University - Northern,911258,1614369,2820000,5345627,0
MA,Anna Maria College,911801,1619045,2809000,5339846,0
NC,Brunswick Community College,795340,1651117,2893000,5339457,0
MD,All-State Career,5309772,0,0,5309772,0
MO,Fontbonne University,986867,1567916,2750000,5304783,0
AL,Birmingham-Southern College,1069855,1533280,2696000,5299135,0
NY,Manhattan School Of Computer Technology,801874,1639673,2838000,5279547,0
TX,Howard Payne University,1041913,1536043,2687000,5264956,62865000
IN,Huntington University,960261,1561180,2741000,5262441,0
OK,Oklahoma Panhandle State University,882583,1591219,2781000,5254802,0
NC,Greensboro College,962182,1553970,2717000,5233152,0
MN,Fond Du Lac Tribal & Community College,744831,1624762,2862000,5231593,0
MD,Washington Adventist University,805558,1602392,2813000,5220950,0
MD,Washington College,1047397,1494341,2678000,5219738,236685000
NY,Talmudical Seminary Of Bobov,949733,1467438,2798000,5215171,0
OK,University Of Science & Arts Of Oklahoma,1020519,1529512,2662000,5212031,0
NC,Salem College,1007410,1532126,2669000,5208536,0
AR,Baptist Health College Little Rock,876349,1410310,2918000,5204659,0
SC,Presbyterian College,1038216,1506419,2650000,5194635,91533000
SC,Southern Wesleyan University,841417,1583800,2768000,5193217,0
MI,Kirtland Community College,712739,1629004,2842000,5183743,0
UT,Ogden-Weber Technical College,596044,1595765,2991000,5182809,0
OK,Mid-America Christian University,716752,1622104,2832000,5170856,0
TN,Tennessee College Of Applied Technology - Murfreesboro,607231,1165386,3392000,5164617,0
KS,Bethany College,1005488,1511010,2632000,5148498,0
WV,Davis & Elkins College,980322,1518906,2646000,5145228,0
NC,Wilson Community College,718656,1606406,2819000,5144062,0
CA,Western University Of Health Sciences,1105699,1417353,2620000,5143052,0
NH,Rivier University,902722,1529331,2703000,5135053,41389000
NJ,Jersey College,5119863,0,0,5119863,0
PA,Bryn Mawr College,1022842,1472661,2623000,5118503,907976000
GA,Young Harris College,1019320,1486015,2609000,5114335,0
NY,Saint Thomas Aquinas College,489023,1662920,2953000,5104943,0
AR,University Of Arkansas For Medical Sciences,972976,1458213,2622000,5053189,0
NE,Hastings College,1051950,1452549,2544000,5048499,0
KY,Midway University,892872,1614558,2535000,5042430,0
CA,Uei College,5025381,0,0,5025381,0
KY,Georgetown College,934826,1481847,2605000,5021673,0
NY,Clinton Community College - Suny Office Of Community Colleges,765962,1545848,2705000,5016810,0
PA,Manor College,790389,1541671,2678000,5010060,0
VA,Washington And Lee University,1045044,1418018,2539000,5002062,1676308000
NC,Beaufort County Community College,695419,1563932,2742000,5001351,0
NC,Lees-Mcrae College,925656,1485773,2587000,4998429,0
MO,William Woods University,894737,1476897,2620000,4991634,0
PA,Wilson College,843869,1498967,2647000,4989836,55338000
WV,New River Community And Technical College,688982,1567267,2731000,4987249,0
KS,Seward County Community College,734560,1535377,2712000,4981937,0
AL,J. F. Drake State Community And Technical College,761763,1539687,2679000,4980450,0
SD,Mitchell Technical Institute,879422,1485562,2600000,4964984,0
CA,Holy Names University,895448,1475062,2577000,4947510,54171000
AR,Southern Arkansas University Tech,782909,1507722,2645000,4935631,0
UT,Mountainland Technical College,609482,1545193,2778000,4932675,0
FL,Pinellas Technical College - St. Petersburg Campus,621026,1536181,2766000,4923207,0
WI,Wisconsin Lutheran College,925999,1448476,2543000,4917475,36629000
KY,Centre College Of Kentucky,986773,1421366,2509000,4917139,0
FL,North Florida College,715483,1528120,2673000,4916603,0
AR,Arkansas Baptist College,831019,1482487,2597000,4910506,0
CA,California State University Maritime Academy,977757,1381700,2550000,4909457,0
PA,Peirce College,611389,1562718,2722000,4896107,23557000
SC,University Of South Carolina - Salkehatchie,783241,1496153,2608000,4887394,0
NY,Maria College,697463,1370774,2393000,4461237,0
SD,Northern State University,659777,1518172,2699000,4876949,0
VA,Eastern Mennonite University,893425,1442117,2540000,4875542,0
CA,Chicago School Of Professional Psychology,756112,1860461,2256000,4872573,0
CA,Simpson University,892430,1445294,2518000,4855724,0
GA,Paine College,798094,1484462,2571000,4853556,0
TN,University Of Tennessee Health Science Center,998078,1363552,2491000,4852630,0
LA,Blue Cliff College,4843075,0,0,4843075,0
ME,Bates College,953516,1395754,2487000,4836270,329723000
IA,Central College,928577,1416092,2488000,4832669,118586000
GA,Emmanuel College,871449,1442139,2519000,4832588,151725000
KY,Kentucky Wesleyan College,843204,1448016,2523000,4814220,0
PA,Philadelphia Technician Training Institute,675783,1503388,2626000,4805171,0
MN,Minnesota State College Southeast,666447,1499186,2636000,4801633,0
CA,California Institute Of The Arts,1014886,1365215,2418000,4798101,178839000
MT,Rocky Mountain College,933392,1401924,2455000,4790316,32055000
CA,Uei College,4785647,0,0,4785647,0
MN,Hibbing Community College,779596,1451871,2540000,4771467,0
OK,"Indian Capital Technology Center, School District Number 4",885933,1404206,2480000,4770139,0
OR,Warner Pacific University,778206,1451123,2538000,4767329,0
NC,James Sprunt Community College,661318,1375164,2728000,4764482,0
IL,Spoon River College,617648,1506166,2639000,4762814,0
CA,Feather River College,599153,1495117,2666000,4760270,0
ME,Thomas College,762266,1438966,2540000,4741232,19614000
OH,Belmont College,773450,1444467,2523000,4740917,0
IL,Blackburn University,913064,1398751,2428000,4739815,0
IA,Briar Cliff University,853293,1407399,2467000,4727692,0
PA,Thiel College,931754,1380896,2406000,4718650,0
IL,Devry University,4713768,0,0,4713768,0
IN,Earlham College,958680,1361707,2391000,4711387,418845000
MT,Carroll College,941622,1361291,2401000,4703913,44828000
MI,Rochester University,787257,1424071,2486000,4697328,0
WI,Ripon College,908784,1364469,2422000,4695253,94328000
AR,College Of The Ouachitas,669324,1457805,2553000,4680129,0
KS,Independence Community College,746807,1432021,2500000,4678828,0
NY,Sarah Lawrence College,944456,1338169,2391000,4673625,117046000
SC,Northeastern Technical College,544363,1504443,2624000,4672806,0
PA,Pennsylvania College Of Health Sciences,778640,1405978,2472000,4656618,0
MN,Itasca Community College,741976,1421466,2493000,4656442,0
FL,Ave Maria University,927779,1339857,2377000,4644636,0
NY,Paul Smith'S College Of Arts & Sciences,922258,1357184,2364000,4643442,0
CT,Porter And Chester Institute,4642939,0,0,4642939,0
OH,Kenyon College,940498,1315552,2382000,4638050,422019000
KY,Transylvania University,878886,1278124,2472000,4629010,191238000
AR,Central Baptist College,822986,1385745,2412000,4620731,0
TX,Western Texas College,556115,1449094,2614000,4619209,0
WI,Milwaukee Institute Of Art & Design,840652,1374550,2395000,4610202,0
NY,Elmira College,917861,1340299,2344000,4602160,0
NY,Relay Graduate School Of Education,740441,1355661,2506000,4602102,0
NY,Albany College Of Pharmacy And Health Sciences,941221,1299052,2360000,4600273,0
NY,Berkeley College,4596874,0,0,4596874,0
OR,Corban University,887403,1343986,2364000,4595389,0
CA,Westmont College,950992,1311893,2316000,4578885,78908000
NY,Metropolitan Learning Institute,660220,1394537,2521000,4575757,0
CA,Marymount California University,874466,1342246,2345000,4561712,0
FL,Orange Technical College - Mid Florida Campus,538345,1444270,2573000,4555615,0
NY,Yeshiva Of Machzikai Hadas,895153,1337216,2318000,4550369,0
OK,Redlands Community College,608459,1427978,2511000,4547437,0
IA,Cornell College,845562,1330085,2367000,4542647,76288000
PR,Edic College,4538123,0,0,4538123,0
OK,Oklahoma Wesleyan University,797766,1361300,2379000,4538066,0
MT,Helena College University Of Montana,685627,1394148,2451000,4530775,0
HI,Windward Community College,551098,1432714,2539000,4522812,0
OH,Marietta College,870471,1322182,2330000,4522653,88469000
ME,York County Community College,556529,1436695,2521000,4514224,0
OK,Western Oklahoma State College,635791,1409851,2463000,4508642,0
IA,Mercy College Of Health Sciences,805957,1345841,2347000,4498798,0
PA,Cairn University,771522,1343540,2364000,4479062,0
ND,University Of Jamestown,848958,1316400,2310000,4475358,0
TX,Southwestern Adventist University,801162,1339319,2334000,4474481,0
NY,Villa Maria College Of Buffalo,807056,1340693,2325000,4472749,0
IA,Marshalltown Community College,636628,1384816,2445000,4466444,0
NJ,Berkeley College,4464258,0,0,4464258,0
KS,Kansas Wesleyan University,823462,1320499,2303000,4446961,0
CA,Samuel Merritt University,841525,1284267,2310000,4435792,51316000
CA,California Institute Of Technology,908781,1254418,2270000,4433199,2975376000
IL,Southeastern Illinois College,460547,1429347,2537000,4426894,0
NV,Roseman University Of Health Sciences,893841,1213666,2307000,4414507,0
NC,University Of North Carolina School Of The Arts,868886,1268365,2259000,4396251,0
LA,University Of Holy Cross,708685,1338263,2348000,4394948,0
NJ,Salem Community College,665129,1352495,2372000,4389624,0
ME,Maine Maritime Academy,876568,1263932,2248000,4388500,0
IA,Northwestern College,822778,1291574,2273000,4387352,0
LA,Franciscan Missionaries Of Our Lady University,721431,1324432,2338000,4383863,0
OH,Lake Erie College,803405,1292618,2272000,4368023,0
ME,University Of Maine - Fort Kent,626037,1353803,2386000,4365840,0
NC,Haywood Community College,614386,1361522,2385000,4360908,0
WY,Northwest College,732668,1311889,2313000,4357557,38942000
IL,Methodist College,736004,1319115,2298000,4353119,22069000
MN,Pine Technical And Community College,481263,1397218,2470000,4348481,0
NY,Hilbert College,683112,1329533,2331000,4343645,0
SC,University Of South Carolina - Sumter,705800,1321358,2316000,4343158,0
KY,Alice Lloyd College,754640,1309966,2277000,4341606,0
NC,Bennett College,768798,1301805,2264000,4334603,0
PA,Haverford College,873803,1246052,2210000,4329855,529487000
MA,Hult International Business School,882754,1209495,2224000,4316249,0
TX,Richland College,4316107,0,0,4316107,0
ME,Unity College,822158,1266150,2214000,4302308,77308000
MO,Kansas City Art Institute,840665,1262617,2199000,4302282,0
MN,Minneapolis College Of Art & Design,807630,1268917,2217000,4293547,0
PA,Rosedale Technical College,842493,1252706,2192000,4287199,0
AL,Fortis College,4282458,0,0,4282458,0
MI,West Shore Community College,564751,1225927,2491000,4281678,0
WV,Wheeling University,766653,1274648,2240000,4281301,0
ME,Northern Maine Community College,655429,1320610,2304000,4280039,0
OR,Reed College,842657,1237124,2197000,4276781,579820000
ME,Saint Joseph'S College,649094,1306280,2315000,4270374,0
PW,Palau Community College,759490,1283232,2225000,4267722,0
FL,George T. Baker Aviation Technical College,624978,1323182,2316000,4264160,0
MA,Benjamin Franklin Institute Of Technology,814858,1256813,2190000,4261671,0
WY,Central Wyoming College,578937,1328069,2347000,4254006,0
IN,Goshen College,792911,1257733,2203000,4253644,113643000
CA,Hope International University,681856,1229636,2335000,4246492,0
OH,Ursuline College,673311,1294301,2275000,4242612,0
MA,Laboure College,661421,1298168,2268000,4227589,0
VA,Bluefield College,691152,1286307,2247000,4224459,0
ME,University Of Maine - Presque Isle,610998,1310251,2302000,4223249,0
SC,University Of South Carolina - Lancaster,570863,1322097,2324000,4216960,0
CA,Claremont Mckenna College,855579,1204979,2133000,4193558,865475000
MS,Blue Mountain College,784621,1241220,2162000,4187841,0
ID,College Of Idaho (The),809015,1222831,2146000,4177846,0
FL,New College Of Florida,837170,1196735,2143000,4176905,0
KS,Mcpherson College,795375,1229981,2150000,4175356,47125000
NC,Brevard College,782339,1235952,2155000,4173291,28160000
IA,Ellsworth Community College,715943,1253256,2188000,4157199,0
GA,Covenant College,822751,1203174,2116000,4141925,42681000
NC,Warren Wilson College,776538,1224969,2140000,4141507,51270000
VA,Hollins University,799714,1184387,2152000,4136101,182729000
SC,Williamsburg Technical College,589306,1235202,2307000,4131508,0
NV,Great Basin College,470059,1323265,2338000,4131324,0
MA,Eastern Nazarene College,761413,1225868,2143000,4130281,0
MI,Gogebic Community College,661272,1259603,2201000,4121875,0
AR,Arkansas Northeastern College,566883,1289032,2262000,4117915,0
MN,Mesabi Range College,561010,1289340,2263000,4113350,0
IN,Wabash College,810923,1197190,2098000,4106113,344252000
NC,Montreat College,735993,1225163,2142000,4103156,0
CA,"University Of California, San Francisco",867955,1133080,2095000,4096035,0
SC,Medical University Of South Carolina,937694,1114732,2042000,4094426,375593000
MI,Dorsey School Of Business,4088414,0,0,4088414,0
HI,Kauai Community College,535684,1285285,2259000,4079969,0
IA,Southwestern Community College,587388,1264937,2224000,4076325,0
MO,Hannibal - Lagrange University,759488,1196420,2091000,4046908,0
NC,Halifax Community College,616040,1241708,2175000,4032748,0
NC,Piedmont Community College,569586,1256023,2202000,4027609,33276000
TX,Southwest University At El Paso,4026674,0,0,4026674,0
AZ,Arizona Christian University,747009,1188662,2074000,4009671,0
IN,Saint Mary Of The Woods College,637917,1227989,2143000,4008906,0
MA,Fisher College,496691,1265283,2245000,4006974,97743000
OH,Cleveland Institute Of Art (The),801788,1162031,2026000,3989819,0
MI,Glen Oaks Community College,576681,1232639,2167000,3976320,0
MS,Millsaps College,761840,1161398,2050000,3973238,0
NE,Union College,757995,1167914,2047000,3972909,466372000
TX,Milan Institute,3963075,0,0,3963075,0
CA,Lake Tahoe Community College,348926,1290394,2322000,3961320,0
IA,Clarke University,768683,1155469,2032000,3956152,29340000
TN,Milligan College,742753,1160607,2050000,3953360,0
SC,Columbia International University,676941,1183116,2080000,3940057,0
MI,Grace Christian University,485111,1257228,2189000,3931339,0
PA,Pennsylvania Institute Of Technology,518726,1247621,2164000,3930347,0
OH,Bluffton University,768698,1144619,2001000,3914317,0
IA,Iowa Wesleyan University,699320,1171539,2042000,3912859,0
NY,Cooper Union For The Advancement Of Science & Art (The),766505,1110434,2033000,3909939,0
FL,Sunstate Academy,814778,1435284,1656000,3906062,0
WA,Whitman College,764766,1128146,2009000,3901912,565256000
VA,Paul D. Camp Community College,512617,1227213,2154000,3893830,0
PR,Escuela De Artes Plasticas Y Diseño De Puerto Rico,686208,1170824,2034000,3891032,0
NY,Rabbinical College Bobover Yeshiva Bnei Zion,751000,1148403,1988000,3887403,0
NH,Colby-Sawyer College,779605,1128568,1977000,3885173,39449000
TN,Bryan College,579257,1199750,2106000,3885007,0
PR,Instituto Comercial De Puerto Rico Junior College,3879773,0,0,3879773,0
FL,William T Mcfatter Technical College,603976,1180478,2083000,3867454,0
FL,Traviss Technical College,644793,1173090,2038000,3855883,0
TN,Tennessee College Of Applied Technology-Jackson,510365,1124050,2208000,3842415,0
CA,Touro University,797347,1069020,1975000,3841367,0
AZ,Carrington College,3823185,0,0,3823185,0
KS,Sterling College,662915,1151312,2008000,3822227,0
MO,Westminster College,768643,1111314,1942000,3821957,116515000
PA,Philadelphia College Of Osteopathic Medicine,863192,1038054,1919000,3820246,417899000
FL,Pinellas Technical College - Clearwater Campus,527113,1190438,2095000,3812551,0
ND,Dickinson State University,640093,1148421,2024000,3812514,0
PA,Rosemont College,653142,1142284,2004000,3799426,0
CA,Academy Of Art University,3791776,0,0,3791776,0
IA,Palmer College Of Chiropractic,809390,1049646,1932000,3791036,58825000
NY,Central Yeshiva Tomchei Tmimim Lubavitz,743134,1111506,1934000,3788640,0
KY,Brescia University,504094,1196232,2086000,3786326,0
WI,Nicolet Area Technical College,484116,1192563,2092000,3768679,0
CA,Los Angeles Film School (The),3766527,0,0,3766527,0
FL,Academy For Nursing And Health Occupations,541389,1174616,2040000,3756005,0
AR,University Of Arkansas Community College Rich Mountain,542149,1170671,2043000,3755820,0
FL,Fort Myers Technical College,507574,1134896,2113000,3755470,0
FL,Lake Technical College,568563,1157066,2027000,3752629,0
NC,Mayland Community College,588968,1146354,2014000,3749322,0
IL,East-West University,638436,1135709,1965000,3739145,0
PA,Cheyney University Of Pennsylvania,663615,1044814,2030000,3738429,0
LA,Aveda Arts & Sciences Institute Covington,3712040,0,0,3712040,0
KS,Southwestern College,490411,1166646,2044000,3701057,0
AR,Lyon College,680216,1096447,1913000,3689663,0
CA,Menlo College,744390,1064287,1864000,3672677,0
PR,Cem College,3669368,0,0,3669368,0
NH,White Mountains Community College,488503,1152186,2017000,3657689,0
SD,Dakota Wesleyan University,641844,1094081,1918000,3653925,0
TX,Eastfield College,3649693,0,0,3649693,0
CA,Laguna College Of Art And Design,661479,1081100,1892000,3634579,0
FL,South Florida Institute Of Technology,3625271,0,0,3625271,0
NC,Mcdowell Technical Community College,527975,1113327,1953000,3594302,0
FL,Osceola Technical College,590003,1094090,1908000,3592093,0
FL,Lindsey Hopkins Technical College,501691,1119239,1967000,3587930,0
TN,South College,3576321,0,0,3576321,0
GA,Truett Mcconnell University,489215,1105771,1971000,3565986,0
CO,Naropa University,656811,1053383,1853000,3563194,0
GA,Helms College,602995,1077607,1869000,3549602,0
IL,Rush University,683762,1008068,1845000,3536830,620253000
CA,North-West College,3525534,0,0,3525534,0
TX,Western Technical College,3503977,0,0,3503977,0
LA,Fortis College,3493748,0,0,3493748,0
ND,United Tribes Technical College,339952,1151040,1995000,3485992,0
OH,Christ College Of Nursing And Health Sciences,567902,1060598,1852000,3480500,0
OH,Defiance College,662680,1026944,1790000,3479624,19129000
CA,Gurnick Academy Of Medical Arts,3477356,0,0,3477356,0
OH,Mount Carmel College Of Nursing,605611,1029901,1837000,3472512,0
CO,Lamar Community College,588420,1049005,1835000,3472425,0
TN,Tennessee College Of Applied Technology-Livingston,479769,1082755,1905000,3467524,0
CT,Mitchell College,616528,1036072,1814000,3466600,0
KS,Pratt Community College,518364,1065589,1876000,3459953,0
MO,Stephens College,668976,1014615,1771000,3454591,0
TN,Tennessee College Of Applied Technology - Crossville,499909,1069622,1884000,3453531,0
MO,William Jewell College,707592,989524,1739000,3436116,0
OR,Clatsop Community College,444841,1078746,1911000,3434587,0
GA,Toccoa Falls College,481239,1067910,1880000,3429149,0
TX,Frank Phillips College,488436,1065020,1871000,3424456,0
VA,Hampden Sydney College,679908,988698,1749000,3417606,0
GA,Wesleyan College,587801,1027993,1801000,3416794,0
MO,Goldfarb School Of Nursing At Barnes-Jewish College,669542,989079,1745000,3403621,0
NY,Wells College,623035,1014898,1765000,3402933,0
KS,Allen County Community College,416499,1076217,1909000,3401716,0
OH,Fortis College,3398488,0,0,3398488,0
CA,Life Pacific University,606084,1017845,1772000,3395929,0
KS,Colby Community College,469448,1052247,1863000,3384695,0
NM,Southwestern Indian Polytechnic Institute,593278,1017848,1770000,3381126,0
FL,Marion Technical College,541724,1034079,1803000,3378803,0
TN,Tennessee College Of Applied Technology - Newbern,571359,961675,1839000,3372034,0
VA,Randolph College,664874,984559,1721000,3370433,0
OK,Northeast Technology Center,456375,1037246,1867000,3360621,0
WI,Northland College,636542,992151,1731000,3359693,0
NE,Nebraska Methodist College Of Nursing & Allied Health,557892,1011693,1779000,3348585,0
NC,Tri-County Community College,522349,1026395,1797000,3345744,0
UT,Bridgerland Technical College,411631,1053906,1874000,3339537,0
NH,Lakes Region Community College,439512,1044695,1848000,3332207,0
CA,Platt College,3330094,0,0,3330094,0
TX,Art Institute Of Houston (The),3313919,0,0,3313919,0
CA,Palo Verde College,349166,1038714,1910000,3297880,0
NJ,Pillar College,562480,996324,1736000,3294804,0
NY,State University Of New York Downstate Medical Center,658028,927377,1688000,3273405,0
PA,Pittsburgh Institute Of Aeronautics,458946,1013613,1780000,3252559,0
GA,Thomas University,375530,1037983,1836000,3249513,29605000
AL,Fortis Institute,3246774,0,0,3246774,0
FL,Tom P. Haney Technical Center,539960,988396,1717000,3245356,0
SD,Mount Marty College,489509,986775,1754000,3230284,0
IL,Eureka College,624909,947882,1654000,3226791,0
PA,University Of Valley Forge,599907,955627,1670000,3225534,0
WV,Bethany College,582649,962066,1679000,3223715,0
KS,Wichita Technical Institute,3213488,0,0,3213488,0
FL,College Of The Florida Keys (The),481856,989069,1740000,3210925,0
PA,Clarks Summit University,596633,942626,1666000,3205259,0
MO,St. Louis College Of Pharmacy,678296,908540,1618000,3204836,144776000
IN,Oakland City University,465821,981448,1744000,3191269,0
IA,Northwest Iowa Community College,422535,996810,1771000,3190345,0
SC,University Of South Carolina - Union,457913,986521,1740000,3184434,0
GA,Art Institute Of Atlanta (The),3179031,0,0,3179031,0
FL,Ridge Technical College,516450,970771,1690000,3177221,0
CA,Institute Of Technology,3164257,0,0,3164257,0
WA,Cornish College Of The Arts,632813,915631,1613000,3161444,0
AK,University Of Alaska Southeast,372939,1001982,1784000,3158921,0
CA,Pitzer College,625861,913259,1619000,3158120,144365000
PR,Automeca Technical College,3157261,0,0,3157261,0
CA,American Career College,3157248,0,0,3157248,0
CA,Unitek College,3157044,0,0,3157044,0
VA,Dabney S Lancaster Community College,444563,981191,1725000,3150754,0
MN,Martin Luther College,531043,945500,1670000,3146543,0
MN,Crown College,491090,960841,1686000,3137931,0
FL,Suncoast Technical College,425821,971627,1739000,3136448,0
PA,Orleans Technical College,582950,931256,1620000,3134206,0
MO,Midwestern Baptist Theological Seminary,466997,948700,1713000,3128697,0
MO,Cox College,492010,955693,1678000,3125703,0
OH,Hondros College Of Nursing,3120827,0,0,3120827,0
CT,American Institute,3113907,0,0,3113907,0
TN,Tennessee College Of Applied Technology-Shelbyville,547306,931766,1631000,3110072,0
MD,Garrett College,504992,947671,1655000,3107663,0
NY,New York College Of Health Professions,537043,930830,1629000,3096873,0
IL,Maccormac College,382008,992573,1720000,3094581,0
OH,Fortis College,3093935,0,0,3093935,0
FL,Sunstate Academy,478081,947773,1656000,3081854,0
LA,Centenary College Of Louisiana,608956,890394,1579000,3078350,0
CO,Morgan Community College,411258,966838,1698000,3076096,0
GA,Brewton Parker College,449184,950942,1665000,3065126,0
TX,University Of North Texas Health Science Center At Fort Worth,687698,832399,1539000,3059097,0
OK,Canadian Valley Technology Center School District No. 6,601347,872268,1583000,3056615,0
KY,Kentucky Christian University,531102,919413,1605000,3055515,0
NH,River Valley Community College,384684,965201,1705000,3054885,0
IL,Robert Morris University Illinois,3052761,0,0,3052761,0
SC,Erskine College,587364,894189,1570000,3051553,0
WY,Eastern Wyoming College,420524,945262,1685000,3050786,0
CA,Lassen College,335004,963037,1733000,3031041,0
KS,North Central Kansas Technical College,490545,917405,1613000,3020950,0
NM,Luna Community College,399419,948067,1673000,3020486,0
PA,Johnson College,559569,897027,1561000,3017596,0
TX,University Of Texas Southwestern Medical Center (The),602606,843650,1560000,3006256,0
IN,Calumet College Of Saint Joseph,562456,886885,1554000,3003341,0
WA,City University Of Seattle,432868,918942,1651000,3002810,0
VT,Bennington College,592763,869044,1534000,2995807,0
FL,Lorenzo Walker Technical College,492820,858353,1634000,2985173,0
FL,Robert Morgan Educational Center And Technical College,447181,917050,1616000,2980231,0
MI,Ross Medical Education Center,2973094,0,0,2973094,0
NY,Erie 1 Board Of Cooperative Educational Services,577270,868446,1524000,2969716,0
FL,George Stone Technical College,446933,916920,1605000,2968853,0
OR,Columbia Gorge Community College,375638,938681,1654000,2968319,0
PR,Conservatorio De Música De Puerto Rico,548486,878541,1531000,2958027,0
OK,Southwestern Christian University,534184,879278,1528000,2941462,0
KS,Tabor College,525581,874230,1530000,2929811,0
CA,Golden Gate University,464148,871390,1580000,2915538,46828000
NV,Sierra Nevada College,553670,852648,1508000,2914318,0
NY,Seminar L'Moros Bais Yaakov,644413,829572,1439000,2912985,0
MO,A. T. Still University Of Health Sciences,539820,831012,1536000,2906832,0
KY,Sullivan University,2903218,0,0,2903218,0
TX,Mountain View College,2902459,0,0,2902459,0
IL,Rosalind Franklin University Of Medicine And Science,600592,807025,1492000,2899617,0
TN,Sae Institute Of Technology,2892306,0,0,2892306,0
CO,Colorado Northwestern Community College,397997,898356,1593000,2889353,0
MI,Walsh College Of Accountancy & Business Administration,422403,888354,1578000,2888757,9730000
MO,Ozark Christian College,489464,871809,1521000,2882273,0
NY,Word Of Life Bible Institute,506756,858197,1503000,2867953,0
ND,Valley City State University,452941,868060,1532000,2853001,0
TX,Valley Grande Institute For Academic Studies,422034,885308,1535000,2842342,0
AR,Williams Baptist University,528721,839882,1465000,2833603,0
KS,Central Christian College Of Kansas,464984,861626,1506000,2832610,0
KS,Northwest Kansas Technical College,479285,841008,1493000,2813293,0
AL,Reid State Technical College,435328,866379,1508000,2809707,0
CA,Hacienda La Puente Adult Education,388304,853390,1559000,2800694,0
PA,Prism Career Institute,2799781,0,0,2799781,0
OK,Metro Technology Centers School District #22,466807,836177,1491000,2793984,0
OH,Kettering College,525294,817668,1451000,2793962,0
NY,School Of Visual Arts,2793698,0,0,2793698,0
PA,Lancaster County Career And Technology Center,508099,824731,1454000,2786830,0
FL,Miami Lakes Educational Center And Technical College,362478,866414,1556000,2784892,0
OR,Pacific Northwest College Of Art,456256,779482,1548000,2783738,0
NY,Mildred Elley,2777967,0,0,2777967,0
NY,Talmudical Seminary Oholei Torah,538150,818735,1420000,2776885,0
NY,Allen School,2769386,0,0,2769386,0
WA,Northwest Indian College,403967,862256,1503000,2769223,0
FL,Miami International University Of Art & Design,2762168,0,0,2762168,0
NC,Southeastern Baptist Theological Seminary,347269,847381,1567000,2761650,0
CA,Southern California University Of Health Sciences,401546,832703,1518000,2752249,0
MN,Vermilion Community College,454539,830732,1460000,2745271,0
TN,Tennessee College Of Applied Technology - Hohenwald,261811,871170,1610000,2742981,0
CA,Institute For Business & Technology,2735892,0,0,2735892,0
CA,Casa Loma College,506509,739820,1488000,2734329,0
CA,Scripps College,546083,785174,1401000,2732257,375585000
NC,Mycomputercareer.Com,2727181,0,0,2727181,0
GA,Aviation Institute Of Maintenance,2722482,0,0,2722482,0
VA,Edward Via Virginia College Of Osteopathic Medicine,589803,747735,1382000,2719538,0
CT,New England Tractor Trailer Training School Of Connecticut,2717490,0,0,2717490,0
AL,J.F. Ingram State Technical College,448264,822536,1443000,2713800,0
OK,Moore Norman Technology Center School District No. 17,278987,862226,1558000,2699213,0
SD,Sinte Gleska University,385959,838117,1466000,2690076,0
VA,Stratford University,2689835,0,0,2689835,0
NY,Helene Fuld College Of Nursing,445514,816859,1426000,2688373,0
KY,Ata College,2684973,0,0,2684973,120223000
NY,American Academy Of Dramatic Arts,533811,778823,1367000,2679634,0
SD,Presentation College,454681,807234,1410000,2671915,0
NE,Clarkson College,441901,806294,1419000,2667195,0
KS,Bethel College,531372,777483,1358000,2666855,0
MA,Pine Manor College,518912,782334,1363000,2664246,0
NY,United States Merchant Marine Academy,569967,708815,1381000,2659782,0
MN,Bethany Lutheran College,471985,789349,1390000,2651334,44117000
IN,Ancilla Domini College,492118,784978,1366000,2643096,0
VA,Virginia University Of Lynchburg,357917,835545,1449000,2642462,0
NE,Bryan College Of Health Sciences,484417,780709,1377000,2642126,0
NY,State University Of New York Upstate Medical University,519926,748378,1357000,2625304,0
KS,Flint Hills Technical College,306504,829141,1487000,2622645,0
FL,Orange Technical College - Westside Campus,293856,834853,1490000,2618709,0
WI,Maranatha Baptist University,410308,792518,1394000,2596826,0
FL,Okaloosa Technical College And Choice High School,393330,792866,1410000,2596196,0
CA,Pacific Oaks College,340238,815692,1434000,2589930,0
NC,Montgomery Community College,382976,799600,1401000,2583576,0
SC,Denmark Technical College,412522,787267,1376000,2575789,0
OK,Gordon Cooper Technology Center,509679,746137,1319000,2574816,0
NY,Empire Beauty School,2572614,0,0,2572614,0
AL,Marion Military Institute,514237,742268,1307000,2563505,0
KS,Manhattan Area Technical College,369841,790612,1399000,2559453,0
CA,Harvey Mudd College,516332,733506,1303000,2552838,328568000
SC,Bob Jones University,2552058,0,0,2552058,0
TX,El Centro College,2550619,0,0,2550619,0
NH,Granite State College,269441,819990,1438000,2527431,0
NY,Juilliard School (The),524199,712263,1289000,2525462,0
ME,Maine College Of Art,507454,734222,1283000,2524676,0
MI,Ross Medical Education Center,2521578,0,0,2521578,0
PA,Hussian College,2519530,0,0,2519530,0
NM,Saint John'S College,377298,544087,1594000,2515385,0
FL,Withlacoochee Technical College,403755,769396,1340000,2513151,0
TX,Interactive College Of Technology,2503478,0,0,2503478,0
MI,Finlandia University,447690,748336,1304000,2500026,0
TX,North Lake College,2498181,0,0,2498181,0
CA,Humphreys University,398142,764036,1335000,2497178,0
FL,Florida Panhandle Technical College,378062,768153,1340000,2486215,0
ND,Williston State College,338809,772089,1360000,2470898,0
OR,Multnomah University,433018,738474,1294000,2465492,0
MA,Mgh Institute Of Health Professions,500795,687131,1271000,2458926,0
TN,Tennessee College Of Applied Technology-Paris,394967,752114,1310000,2457081,0
LA,Unitech Training Academy,2453939,0,0,2453939,0
NJ,Fortis Institute,2435661,0,0,2435661,0
NJ,Jfk Medical Center Muhlenberg Harold B. And Dorothy A. Snyder Schools,417854,733771,1281000,2432625,0
FL,Florida College,445256,722456,1264000,2431712,0
NE,York College,459315,716808,1251000,2427123,0
VA,Eastern Shore Community College,338336,754006,1320000,2412342,0
IN,Martin University,395736,735403,1277000,2408139,0
MI,Ross Medical Education Center,2390068,0,0,2390068,0
FL,St. Johns County School District,308355,585637,1495000,2388992,0
NY,Mesivta Torah Vodaath Rabbinical Seminary,459637,663172,1263000,2385809,0
NV,Northwest Career College,2384152,0,0,2384152,0
CA,San Diego Christian College,421905,711004,1244000,2376909,0
CA,Charles A. Jones Career And Education Center,365709,733656,1275000,2374365,0
NV,Milan Institute Of Cosmetology,2373948,0,0,2373948,0
NY,Rabbinical College Of Ohr Shimon Yisroel,460264,694125,1219000,2373389,0
FL,Trinity Baptist College,421907,712214,1239000,2373121,0
CA,Summit College,2365247,0,0,2365247,0
VA,Fortis College,2359780,0,0,2359780,0
OH,Miami Valley Career Technology Center,244731,685943,1428000,2358674,0
MI,Cleary University,384753,714577,1253000,2352330,0
IN,Holy Cross College,469591,682060,1193000,2344651,0
MI,Miat College Of Technology,2341441,0,0,2341441,0
PA,Empire Beauty School,2339199,0,0,2339199,0
ND,Mayville State University,312720,733724,1290000,2336444,0
MT,Blackfeet Community College,266062,753694,1311000,2330756,0
MT,University Of Providence,376995,705742,1245000,2327737,0
PR,Columbia Central University,2321653,0,0,2321653,0
OH,Hobart Institute Of Welding Technology,485886,663262,1164000,2313148,0
NM,Institute Of American Indian & Alaska Native Culture & Artsdevelopment,342519,713431,1254000,2309950,0
CA,Paul Mitchell The School Costa Mesa,2289751,0,0,2289751,0
NY,Manhattan School Of Music,441481,655621,1189000,2286102,0
TX,College Of Biblical Studies-Houston,203755,833405,1245000,2282160,0
TX,Covenant School Of Nursing And Allied Health,403823,681520,1194000,2279343,0
PA,Moore College Of Art And Design,441674,669083,1167000,2277757,0
CA,Ntma Training Centers Of Southern California,427969,672688,1170000,2270657,0
PA,Empire Beauty School,2268234,0,0,2268234,0
TN,Tennessee College Of Applied Technology - Covington,248249,524530,1495000,2267779,0
NM,University Of The Southwest,435854,663788,1166000,2265642,0
FL,Orange Technical College-Winter Park Campus,265697,711621,1286000,2263318,0
PR,Huertas College,2262464,0,0,2262464,0
NC,Roanoke Chowan Community College,353481,691315,1208000,2252796,0
ND,Lake Region State College,110878,371642,1768000,2250520,0
TN,Tennessee College Of Applied Technology - Harriman,411299,663406,1174000,2248705,0
IA,Maharishi International University,408145,657539,1182000,2247684,0
TX,Baylor College Of Medicine,506003,610941,1129000,2245944,1301005000
KS,Hesston College,444466,654430,1143000,2241896,0
RI,New England Tractor Trailer Training School Of Massachusetts,2226771,0,0,2226771,0
AR,Northwest Technical Institute,437217,651865,1134000,2223082,0
MI,Empire Beauty School,2219238,0,0,2219238,0
ND,Sitting Bull College,375048,669488,1164000,2208536,0
NY,Empire Beauty School,2208217,0,0,2208217,0
WA,Bastyr University,501592,606942,1095000,2203534,0
PA,All-State Career School,2203255,0,0,2203255,0
ME,Washington County Community College,341449,678640,1182000,2202089,0
MI,Michigan Barber School,447200,611486,1139000,2197686,0
NY,Albany Schoharie Schenectady Saratoga Boces Practical Nursing Program,416996,650370,1127000,2194366,0
OH,Scioto County Career Technical Center,419892,649101,1125000,2193993,0
NY,Merkaz Bnos,403827,633910,1156000,2193737,0
NY,Western Suffolk Boces,422592,644964,1126000,2193556,0
TX,Brookhaven College,2187307,0,0,2187307,0
TN,Tennessee College Of Applied Technology-Pulaski,263555,661864,1258000,2183419,0
FL,Fred K. Marchman Technical College,320269,673867,1179000,2173136,0
PA,Salus University,503656,586171,1083000,2172827,48896000
PR,Liceo De Arte Y Tecnología,2168379,0,0,2168379,0
CA,Baldwin Park Adult School,319015,657738,1189000,2165753,0
SC,Clinton College,233942,707265,1224000,2165207,0
MI,Ross Medical Education Center,2164321,0,0,2164321,0
NY,King'S College (The),396742,639724,1127000,2163466,0
TN,Concorde Career College,2155995,0,0,2155995,0
CA,Intercoast Colleges,2149757,0,0,2149757,0
TN,Tennessee College Of Applied Technology-Hartsville,318610,659236,1164000,2141846,0
OK,Community Care College,2135245,0,0,2135245,0
FL,Cape Coral Technical College,358183,635804,1127000,2120987,0
AZ,Avalon School Of Cosmetology,2120430,0,0,2120430,0
PA,Valley Forge Military College,385652,600069,1126000,2111721,0
AL,Judson College,369009,632686,1100000,2101695,0
FL,Southern Technical College,2097167,0,0,2097167,0
CO,Pima Medical Institute,2092022,0,0,2092022,0
NM,New Mexico Military Institute,415633,606810,1062000,2084443,0
MO,Kansas City University Of Medicine And Biosciences,409399,587192,1085000,2081591,0
TN,Tennessee College Of Applied Technology-Jacksboro,365951,614625,1090000,2070576,0
KS,Donnelly College,294832,645519,1130000,2070351,0
VA,Centura College,2069211,0,0,2069211,0
FL,Saber College,382767,539191,1147000,2068958,0
WV,Ohio Valley University,405760,577221,1076000,2058981,0
MA,Northpoint Bible College,423110,596720,1039000,2058830,0
OK,Bacone College,509457,565617,983000,2058074,0
GA,Andrew College,355871,617316,1073000,2046187,0
FL,Orange Technical College - Orlando Campus,255268,642991,1143000,2041259,0
MA,Montserrat College Of Art,375198,605741,1057000,2037939,0
PR,Trinity College Of Puerto Rico,394678,599261,1038000,2031939,0
CA,Glendale Career College,2025197,0,0,2025197,0
MI,Thomas M. Cooley Law School,405235,566834,1048000,2020069,0
MD,St. John'S College,398355,571777,1049000,2019132,217294000
PA,Wilkes Barre Area Career And Technical Center Practical Nursing Prgm,335061,601805,1080000,2016866,0
IA,Des Moines University - Osteopathic Medical Center,422290,557988,1032000,2012278,0
PA,Empire Beauty School,2008780,0,0,2008780,0
FL,Beacon College,405430,582246,1018000,2005676,0
NY,Yeshiva Of Nitra Rabbinical College,386639,589386,1022000,1998025,0
PA,Empire Beauty School,1988069,0,0,1988069,0
CA,California Institute Of Integral Studies,352356,577600,1050000,1979956,0
CT,Stone Academy,1976921,0,0,1976921,0
NY,Veeb Nassau County School Of Practical Nursing,391740,578090,1003000,1972830,0
NJ,Ocean County Vocational - Technical Schools,380824,578987,1010000,1969811,0
OH,Ross Medical Education Center,1965598,0,0,1965598,0
IL,Lincoln Christian University,332245,592346,1041000,1965591,0
CA,Homestead Schools,309756,605232,1050000,1964988,0
WI,Medical College Of Wisconsin,386216,552026,1020000,1958242,937909000
PR,Escuela Hotelera De San Juan,1955007,0,0,1955007,0
OH,Butler Technology And Career Development Schools,292763,602897,1057000,1952660,0
FL,National Aviation Academy,1950415,0,0,1950415,0
IL,Capital Area Career Center,371962,571192,989000,1932154,0
CA,Fashion Institute Of Design & Merchandising,1931729,0,0,1931729,0
AZ,Prescott College,301297,589575,1036000,1926872,0
NY,Plaza College,1926657,0,0,1926657,0
ME,Empire Beauty School,1925983,0,0,1925983,0
MN,Northwestern Health Sciences University,388538,543636,989000,1921174,0
VA,Centra College,229579,610634,1070000,1910213,0
CA,Charles R. Drew University Of Medicine And Science,360477,554830,988000,1903307,0
TX,Jacksonville College,283804,585060,1034000,1902864,0
MN,Northwest Technical College - Bemidji,192242,618678,1088000,1898920,0
PA,Lebanon County Career And Technology Center,336929,504439,1053000,1894368,0
NY,Wayne - Finger Lakes Boces,362846,560471,971000,1894317,0
AZ,Brookline College,1890270,0,0,1890270,0
ND,Dakota College At Bottineau,234429,599989,1055000,1889418,0
UT,Dixie Technical College,202805,571074,1113000,1886879,0
NY,Apex Technical School,1885989,0,0,1885989,0
TN,Tennessee College Of Applied Technology Crump,274881,559948,1051000,1885829,0
OK,Central Technology Center School District No. 3,142537,623028,1120000,1885565,0
PA,Central Pennsylvania Institute Of Science And Technology,369675,552704,962000,1884379,0
FL,Riveroak Technical College,269159,532525,1082000,1883684,0
PR,Universidad Pentecostal Mizpa,301648,577248,1002000,1880896,0
OR,Bushnell University,292486,574500,1011000,1877986,0
OH,Stautzenberger College,1866592,0,0,1866592,0
FL,City College,292345,572965,994000,1859310,0
CA,Thomas Aquinas College,354873,519039,984000,1857912,0
NY,Eastern Suffolk Boces,273593,524450,1056000,1854043,0
GA,Beulah Heights University,295126,565763,992000,1852889,0
NM,Mesalands Community College,198978,593738,1060000,1852716,0
OK,"Meridian Technology Center, School District Number 16",302793,556129,993000,1851922,0
VA,Riverside College Of Health Careers,346191,546629,956000,1848820,0
OH,Aultman College Of Nursing And Health Sciences,295724,563861,983000,1842585,0
OH,Great Oaks Career Campuses-Scarlet Oaks,332099,528952,979000,1840051,0
TN,Tennessee College Of Applied Technology Ripley,226994,470019,1140000,1837013,0
PA,Upmc Shadyside,345358,542395,949000,1836753,0
KY,Employment Solutions,275569,483506,1074000,1833075,0
MO,Special School District Of St. Louis County,333269,534788,961000,1829057,0
FL,International Training Careers,397293,522735,904000,1824028,0
TX,College Of Health Care Professions (The),1823842,0,0,1823842,0
MA,New England Conservatory Of Music,367317,520449,934000,1821766,0
NY,Long Island Business Institute,1821234,0,0,1821234,0
CA,West Coast Ultrasound Institute,1805882,0,0,1805882,0
IL,Saint Francis Medical Center College Of Nursing,318356,538606,946000,1802962,0
TX,Dallas Theological Seminary,306745,523837,969000,1799582,0
PA,Bryn Athyn College Of The New Church,348922,527749,922000,1798671,0
MO,Baptist Bible College,360668,568398,869000,1798066,0
PA,Yti Career Institute,1793845,0,0,1793845,0
NJ,Yeshiva Toras Chaim,347751,527203,917000,1791954,0
NY,Machzikei Hadath Rabbinical College,346953,528178,915000,1790131,0
AZ,Refrigeration School (The),1786314,0,0,1786314,0
CA,Claremont Graduate University,295107,522077,966000,1783184,186766000
OH,Good Samaritan College Of Nursing And Health Science,270661,550028,961000,1781689,0
NY,New York Medical College,374257,493127,912000,1779384,83043000
NJ,Rabbinical College Of America,347256,520890,911000,1779146,0
FL,Southern Technical College,1776085,0,0,1776085,0
MO,Cottey College,334857,525514,915000,1775371,110200000
CA,Soka University Of America,351126,511076,912000,1774202,0
OK,Great Plains Technology Center School District Number 9,353682,517164,899000,1769846,0
OH,Valor Christian College,294534,546901,927000,1768435,0
MT,Stone Child College,216798,547688,1000000,1764486,0
NJ,Thomas Edison State University,17249,633035,1113000,1763284,0
MD,Capitol Technology University,288665,531807,936000,1756472,0
GA,Gupton-Jones College Of Funeral Service,275886,538259,933000,1747145,0
TN,Tennessee College Of Applied Technology-Mckenzie,321987,495548,927000,1744535,0
MT,Miles Community College,246778,541465,953000,1741243,0
CA,New York Film Academy,1739271,0,0,1739271,0
OH,Apollo Career Center,168199,544541,1026000,1738740,0
CA,John Paul The Great Catholic University,343805,506092,886000,1735897,0
PR,Theological University Of The Caribbean,281192,525906,919000,1726098,0
NY,Kehilath Yakov Rabbinical Seminary,334422,507413,884000,1725835,0
NJ,New Community Career And Technical Institute,289766,475626,956000,1721392,0
PA,Greater Altoona Career & Technology Center,291116,520740,906000,1717856,0
NY,Yeshiva Gedolah Imrei Yosef D'Spinka,326856,508501,880000,1715357,0
TN,Tennessee College Of Applied Technology - Athens,246105,531907,937000,1715012,0
MO,Bolivar Technical College,240473,537712,935000,1713185,0
CA,Fuller Theological Seminary,293342,497198,919000,1709540,0
KS,Salina Area Technical College,203959,539924,964000,1707883,0
VA,Eastern Virginia Medical School,329653,482539,892000,1704192,107959000
OH,Mid-East Career And Technology Centers - Adult Education,362414,490347,851000,1703761,0
IL,Adler University,260680,502259,929000,1691939,0
VT,Goddard College,320334,497499,874000,1691833,0
FL,Southeastern College,1689659,0,0,1689659,0
MI,Michigan Career And Technical Institute,238067,526316,921000,1685383,0
OH,Chatfield College,260540,519257,903000,1682797,0
MA,Gordon Conwell Theological Seminary,267766,495574,917000,1680340,0
OK,Autry Technology Center District No.15,307354,493832,877000,1678186,0
CA,Clovis Adult Education,166012,435456,1074000,1675468,0
MI,Bay Mills Community College,222497,528866,922000,1673363,0
PR,Universidad Central Del Caribe,305084,494244,872000,1671328,0
CO,Concorde Career College,1667137,0,0,1667137,0
IA,Faith Baptist Bible College & Theological Seminary,297034,496725,869000,1662759,0
WV,Eastern West Virginia Community & Technical College,211888,524164,918000,1654052,0
IA,Allen College,282895,490373,871000,1644268,0
IL,Coyne College,1641135,0,0,1641135,0
NY,Associated Beth Rivkah Schools,284824,495633,859000,1639457,0
OH,Ehove Career Center,228724,513389,896000,1638113,0
AZ,East Valley Institute Of Technology,236123,503990,897000,1637113,0
FL,Emerald Coast Technical College,305110,484527,847000,1636637,0
OH,Columbiana County Vocational School District,242978,506736,878000,1627714,0
TX,King'S University (The),274750,490625,862000,1627375,0
NC,Carolinas College Of Health Sciences,268630,489746,864000,1622376,0
FL,Charlotte Technical College,248791,489765,883000,1621556,0
NY,Mandl School,1620451,0,0,1620451,0
CA,Southern California Institute Of Architecture (The),339620,458145,822000,1619765,0
OR,Tillamook Bay Community College,315778,472016,831000,1618794,0
CA,University Of Antelope Valley,1613796,0,0,1613796,0
TX,University Of Texas Md Anderson Cancer Center,285840,478904,844000,1608744,0
ME,College Of The Atlantic,303385,473835,830000,1607220,0
KY,Simmons College Of Kentucky,240805,499431,866000,1606236,0
CA,National Holistic Institute,1602448,0,0,1602448,0
NY,Yeshiva Karlin Stolin,306121,462864,830000,1598985,0
NY,Icahn School Of Medicine At Mount Sinai,336074,442990,819000,1598064,0
MN,Mayo Clinic College Of Medicine And Science,328294,446290,821000,1595584,0
WV,Carver Career And Technical Education Center,307983,470190,816000,1594173,0
TN,Tennessee College Of Applied Technology - Oneida/Huntsville,213467,460696,920000,1594163,0
FL,Baptist College Of Florida (The),262085,483725,846000,1591810,0
MA,Bard College At Simon'S Rock,312339,463190,815000,1590529,0
TN,Tennessee College Of Applied Technology Whiteville,203162,461879,925000,1590041,0
FL,Brewster Technical College,179902,507564,898000,1585466,0
PR,Institute Of Beauty Careers,1583438,0,0,1583438,0
CO,Colorado Technical University,1581179,0,0,1581179,0
MT,Little Big Horn College,260189,479458,839000,1578647,0
AZ,Tohono O'Odham Community College,199279,508878,870000,1578157,0
GA,Gwinnett College,1577669,0,0,1577669,0
PA,Reading Hospital School Of Health Sciences,269244,475342,833000,1577586,0
PA,Greater Johnstown Area Vocational Technical School,255046,481436,837000,1573482,0
OR,Concordia University,1572272,0,0,1572272,88859000
MA,Boston Architectural College,279755,460236,819000,1558991,11822000
NY,E.D.P. School,259277,475810,823000,1558087,0
FL,Hollywood Institute Of Beauty Careers,1554527,0,0,1554527,0
MA,Lawrence Memorial Hospital School Of Nursing,238782,478023,837000,1553805,0
IA,Emmaus Bible College,313744,451587,787000,1552331,0
MA,University Of Massachusetts Medical School,310132,435006,804000,1549138,0
CA,Palo Alto University,303711,438443,796000,1538154,0
PA,Commonwealth Technical Institute,268150,460825,807000,1535975,0
CA,Southern California Institute Of Technology,1535401,0,0,1535401,0
CA,Yeshiva Ohr Elchonon Chabad - West Coast Talmudical Seminary,286933,453332,788000,1528265,0
NC,Cabarrus College Of Health Sciences,253120,462682,812000,1527802,0
OH,Toledo Public Schools Adult And Continuing Education,219334,471735,832000,1523069,0
MO,Concorde Career College,1519727,0,0,1519727,0
PA,Lenape Technical School,267853,457121,793000,1517974,0
VA,American National University,1508237,0,0,1508237,0
VA,Sweet Briar College,272489,448436,786000,1506925,0
OH,Union Institute & University,187502,476989,836000,1500491,0
OK,Randall University,250159,455448,793000,1498607,0
CO,Ibmc College,1497661,0,0,1497661,0
PA,Automotive Training Center,1497626,0,0,1497626,0
CA,San Francisco Art Institute,283166,438533,773000,1494699,0
ND,Cankdeska Cikana (Little Hoop) Community College,216968,466352,810000,1493320,0
CA,Pomona Adult School,245993,453341,787000,1486334,0
AK,Alaska Pacific University,254627,445957,784000,1484584,0
TX,Ogle School Hair Skin Nails,1482600,0,0,1482600,0
NY,Yeshivath Zichron Moshe,287275,435215,759000,1481490,0
CA,Community Enhancement Services,267036,443325,768000,1478361,0
LA,Louisiana State University Health Sciences Center In Shreveport,316992,407364,750000,1474356,0
CA,High Desert Medical College,1472341,0,0,1472341,0
MN,Bethany Global University,261065,438908,767000,1466973,0
IL,Beck School Of Practical Nursing,274401,402122,782000,1458523,0
TX,South Texas Vocational Technical Institute,1455120,0,0,1455120,0
KY,Asbury Theological Seminary,260367,419058,775000,1454425,150440000
OH,Art Academy Of Cincinnati,247921,440321,766000,1454242,0
SD,National American University,1453446,0,0,1453446,0
PA,Pennsylvania College Of Art & Design,275900,427928,746000,1449828,0
NY,Brooklyn Law School,251110,417427,772000,1440537,0
WI,College Of Menominee Nation,174970,461052,802000,1438022,0
NC,Pamlico Community College,222221,440805,774000,1437026,0
TN,Welch College,230280,437532,767000,1434812,0
NM,Olympian Academy Of Cosmetology,1430238,0,0,1430238,0
OH,Knox County Career Center,168704,457494,801000,1427198,0
MO,Logan University,224284,425016,772000,1421300,0
CT,Post University,1419702,0,0,1419702,0
UT,Uintah Basin Technical College,167365,441354,810000,1418719,0
CA,University Of Saint Katherine,246937,426935,742000,1415872,0
WI,Bellin College,219481,429279,766000,1414760,0
IL,Saint Anthony College Of Nursing,245511,422976,740000,1408487,0
CA,North-West College,1406776,0,0,1406776,0
OK,Southern Oklahoma Area Vocational Technical District #20,252054,409934,743000,1404988,0
AR,Crowley'S Ridge College,265023,415315,722000,1402338,0
CA,Career Care Institute,1401625,0,0,1401625,0
TX,Cedar Valley College,1401492,0,0,1401492,0
CA,Stanbridge University,1395629,0,0,1395629,0
TN,Tennessee College Of Applied Technology--Mcminnville,230898,421547,737000,1389445,0
FL,Radford M. Locklin Technical College,177103,438306,774000,1389409,0
LA,Iti Technical College,1381165,0,0,1381165,0
TX,North American University,244712,410312,726000,1381024,0
OK,College Of The Muscogee Nation,239337,414665,723000,1377002,0
OH,Pickaway Ross County Joint Vocational School District,243181,411338,722000,1376519,0
OH,Career & Technology Education Centers Of Licking County,198541,425891,750000,1374432,0
OH,Tri-Rivers Career Center,247988,411141,715000,1374129,0
OH,Ohio Media School,1374115,0,0,1374115,0
OR,Pioneer Pacific College,1373074,0,0,1373074,0
TX,Paul Mitchell The School Dallas,1367452,0,0,1367452,0
NY,Saint Joseph'S College Of Nursing At St Joseph'S Hospital Health Cente,261644,402069,703000,1366713,0
OH,Professional Skills Institute,1362751,0,0,1362751,0
NY,Dutchess Boces School Of Practical Nursing,229402,381112,748000,1358514,0
OH,Polaris Career Center - Adult Education Department,231446,409778,713000,1354224,0
NJ,Seminary Bnos Chaim,255559,399256,693000,1347815,0
OH,Northern Career Institute,176450,428465,742000,1346915,0
OH,Adult And Community Education @Hudson,284038,388440,674000,1346478,0
NC,Martin Community College,217290,408657,719000,1344947,0
MO,Central Christian College Of The Bible,242288,401542,698000,1341830,0
NC,Paul Mitchell The School Fayetteville,1340711,0,0,1340711,0
FL,Concorde Career Institute,1340456,0,0,1340456,0
NY,New York Law School,271478,374306,692000,1337784,0
CA,John F. Kennedy University,196815,404291,736000,1337106,0
TN,William R Moore College Of Technology,180060,418831,735000,1333891,0
AR,Eastern College Of Health Vocations,1332068,0,0,1332068,0
MN,Leech Lake Tribal College,219804,404474,702000,1326278,0
OK,Spartan College Of Aeronautics And Technology,1326190,0,0,1326190,0
MO,Cape Girardeau Career And Technology Center,206430,407135,711000,1324565,0
MO,Calvary University,216452,402803,705000,1324255,0
MI,Douglas J Aveda Institute,1324125,0,0,1324125,0
IL,National University Of Health Sciences (The),290635,364355,666000,1320990,0
NY,College Of Westchester (The),1320712,0,0,1320712,0
NY,Rochester General-Isabella Graham Hart School Of Practical Nursing,229264,397898,690000,1317162,0
WV,Appalachian Bible College,238981,391112,684000,1314093,0
NC,Mid-Atlantic Christian University,242130,390579,681000,1313709,0
OH,Gallia Jackson Vinton Joint School Adult Education,226505,397080,690000,1313585,0
NY,Erie 2 - Chautauqua - Cattaraugus Boces,165833,239792,902000,1307625,0
CA,Riverside County Office Of Education,186455,400908,718000,1305363,0
CA,Ventura Adult And Continuing Education,207297,399893,697000,1304190,0
NY,Genesee-Livingston-Steuben-Wyoming Boces,262134,377237,662000,1301371,0
CA,"University Of California, Hastings College Of The Law",276618,359671,665000,1301289,0
TX,Paul Mitchell The School Houston,1300078,0,0,1300078,0
NY,Lim College,1293881,0,0,1293881,0
NY,Bill And Sandra Pomeroy College Of Nursing At Crouse Hospital,207843,391341,682000,1281184,0
TX,Pci Health Training Center,1276232,0,0,1276232,0
TX,South Texas College Of Law Houston,263331,353441,653000,1269772,0
OH,Northeast Ohio Medical University,272933,349668,646000,1268601,0
OK,Mid-America Area Vocational-Technical School District No. #8,253644,359584,653000,1266228,0
UT,Tooele Technical College,115803,378812,770000,1264615,0
NY,Saint Elizabeth Medical Center,220241,379861,660000,1260102,0
UT,Southwest Technical College,137095,400716,721000,1258811,0
VT,Landmark College,210858,378549,669000,1258407,0
TX,Houston Training Schools,1254446,0,0,1254446,0
TX,Ogle School Hair Skin Nails,1248354,0,0,1248354,0
FL,Trinity College Of Florida,194883,383451,666000,1244334,0
VA,Tidewater Tech,1243306,0,0,1243306,0
NY,Rabbinical Seminary Of America,258526,350073,634000,1242599,0
MA,Signature Healthcare Brockton Hospital School Of Nursing,216076,374477,652000,1242553,0
PR,Colegio Educativo Tecnológico Industrial,276174,354111,612000,1242285,0
CA,Lincoln University,310107,331212,600000,1241319,0
CA,San Francisco Conservatory Of Music,249016,348163,642000,1239179,43146000
NY,Geneva General Hospital,237274,361172,633000,1231446,0
NC,Piedmont International University,407862,823035,0,1230897,0
KS,Cleveland University-Kansas City,223811,363417,642000,1229228,0
OK,Western Technology Center School District No. 12,240715,357148,631000,1228863,0
FL,College Of Business & Technology,1227280,0,0,1227280,0
KS,Barclay College,214618,368996,643000,1226614,0
CA,Fielding Graduate University,231198,349312,646000,1226510,0
CA,Bethesda University,222826,361033,633000,1216859,0
FL,Universal Career School,1214724,0,0,1214724,0
TX,Concorde Career College,1209817,0,0,1209817,0
NY,Yeshiva Kollel Tifereth Elizer,241572,353452,611000,1206024,0
VA,Sentara College Of Health Sciences,178560,371502,652000,1202062,0
CA,Asher College,1201948,0,0,1201948,0
OK,Mid-Del Technology Center,135205,380123,678000,1193328,0
LA,Delta College Of Arts & Technology,1192751,0,0,1192751,0
FL,Fortis College,1192474,0,0,1192474,0
MD,Ner Israel Rabbinical College,229867,342629,611000,1183496,0
FL,Big Bend Technical College,198157,357947,625000,1181104,0
PA,York County School Of Technology,205192,350014,620000,1175206,0
CO,Intellitec College,1174578,0,0,1174578,0
NY,Hunter Business School,1168966,0,0,1168966,0
NJ,Yeshiva Gedolah Keren Hatorah,229239,342779,596000,1168018,0
NY,Schuyler Steuben Chemung Tioga Allegany Boces,108927,246401,804000,1159328,0
TX,Dallas Institute Of Funeral Service,220704,341830,596000,1158534,0
IL,Blessing Hospital,210868,342254,602000,1155122,0
OH,Hannah E Mullins School Of Practical Nursing,164959,361994,627000,1153953,0
AZ,American Intercontinental University,1150405,0,0,1150405,0
MD,Lincoln College Of Technology,1149547,0,0,1149547,0
TX,Auguste Escoffier School Of Culinary Arts,1148379,0,0,1148379,0
NY,Beth Medrash Meor Yitzchok,228892,334848,584000,1147740,0
PA,"St. Luke'S Hospital Of Bethlehem, Pa",191622,346459,608000,1146081,0
CA,Beaumont Adult School,156954,334960,654000,1145914,0
MA,William James College,232998,320587,590000,1143585,0
CA,Mti College,1142459,0,0,1142459,0
OH,Washington County Career Center Adult Education,146812,354896,640000,1141708,0
OK,Pioneer Technology Center,262829,316361,561000,1140190,0
MO,Rolla Technical Institute Center,210305,307498,620000,1137803,0
OR,Northwest College School Of Beauty,1136700,0,0,1136700,0
ND,Trinity Bible College And Graduate School,204391,339024,593000,1136415,0
AK,Alaska Christian College,201678,342002,592000,1135680,0
WV,West Virginia School Of Osteopathic Medicine,247036,311772,576000,1134808,0
CA,American College Of Healthcare And Technology,1134326,0,0,1134326,0
CO,Intellitec College,1132045,0,0,1132045,0
FL,Cambridge College Of Healthcare & Technology,1131811,0,0,1131811,0
KY,Brighton Center'S Center For Employment Training,92638,368508,666000,1127146,0
PA,Pennsylvania Academy Of The Fine Arts,222164,327432,577000,1126596,0
KS,Manhattan Christian College,204954,333837,583000,1121791,0
NY,Bnos Zion Of Bobov Seminary,215691,331316,574000,1121007,0
CA,Spartan College Of Aeronautics & Technology,1117522,0,0,1117522,0
MI,Northwestern Technological Institute,1108949,0,0,1108949,0
NY,Continental School Of Beauty Culture,1106191,0,0,1106191,0
WV,Academy Of Careers And Technology,174170,328076,601000,1103246,0
WV,Fred W. Eberle Technical Center,121970,257779,723000,1102749,0
NY,St. Paul'S School Of Nursing,1102325,0,0,1102325,0
NY,Albany Medical College,234607,304631,563000,1102238,0
ID,Carrington College,1101321,0,0,1101321,0
CA,Los Angeles County College Of Nursing And Allied Health,174062,336733,588000,1098795,0
OH,Wayne County Schools Career Center,120311,302849,675000,1098160,0
NJ,Holy Name Medical Center School Of Nursing,206390,289450,593000,1088840,0
PR,D'Mart Institute,1086083,0,0,1086083,0
OR,National University Of Natural Medicine,217745,305236,556000,1078981,0
TN,Visible Music College,185814,324819,566000,1076633,0
FL,Immokalee Technical College,181354,323216,570000,1074570,0
TN,Brillare Beauty Institute,191387,305891,577000,1074278,0
PA,New Castle School Of Trades,1073423,0,0,1073423,0
OH,Central School Of Practical Nursing,218545,311893,541000,1071438,0
MT,Dawson Community College,142151,332253,588000,1062404,0
OR,Carrington College,1060396,0,0,1060396,0
MN,Mitchell Hamline School Of Law,212893,296989,549000,1058882,0
NY,St. Paul'S School Of Nursing,1056892,0,0,1056892,0
MT,Fort Peck Community College,151493,324875,579000,1055368,0
TN,Meharry Medical College,219976,292851,541000,1053827,159146000
CA,Providence Christian College,195829,312235,544000,1052064,0
PA,Central Susquehanna Lpn Career Center,211480,306140,532000,1049620,0
PR,Modern Hairstyling Institute,1048362,0,0,1048362,0
AL,Fortis College,1046187,0,0,1046187,0
PR,Advantage Technical College,1045941,0,0,1045941,0
TX,Southwestern Christian College,143039,328569,569000,1040608,0
OH,God'S Bible School & College,154996,321577,562000,1038573,0
MN,Rainy River Community College,161267,317295,559000,1037562,0
PR,Modern Hairstyling Institute,1036256,0,0,1036256,0
SD,Sisseton Wahpeton College,157620,319636,558000,1035256,0
OH,Choffin Career & Technical Center,186502,307569,539000,1033071,0
IL,Northwestern College,1029287,0,0,1029287,0
MO,Saint Louis College Of Health Careers,1026542,0,0,1026542,0
IL,Vandercook College Of Music,158225,308298,560000,1026523,0
CA,Community Christian College,113974,332179,577000,1023153,0
NJ,Eastwick College - Nutley Campus,1022459,0,0,1022459,0
TX,Aviation Institute Of Maintenance,1018117,0,0,1018117,0
PR,"Colegio De Cinematografía, Artes Y Televisión",1018034,0,0,1018034,0
ME,Maine College Of Health Professions,162446,309324,546000,1017770,0
OH,Mdt College Of Health Sciences,1017059,0,0,1017059,0
NJ,Eastern International College,1016203,0,0,1016203,0
KY,Medquest College,1013074,0,0,1013074,0
TX,Ogle School Hair Skin Nails,1012829,0,0,1012829,0
LA,Delta College,1012095,0,0,1012095,25581000
MI,Career Quest Learning Centers,1005286,0,0,1005286,0
NY,New York Chiropractic College,220590,275168,509000,1004758,58663000
MD,North American Trade Schools,1004497,0,0,1004497,0
NY,Bet Medrash Gadol Ateret Torah,196283,293864,511000,1001147,0
TX,Dallas Christian College,164340,302140,530000,996480,0
IN,International Business College,995201,0,0,995201,0
AZ,Studio Academy Of Beauty (The),994090,0,0,994090,0
OH,Sandusky Career Center,174031,292424,527000,993455,0
PA,Fayette County Career & Technical Institute,195264,292091,506000,993355,0
CA,University Of St. Augustine For Health Sciences,993092,0,0,993092,0
PR,Antilles College Of Health,985427,0,0,985427,0
MO,South Central Career Center,176341,286468,522000,984809,0
PA,Pittsburgh Institute Of Mortuary Science,170652,293693,519000,983345,0
PA,Citizens School Of Nursing,174244,292971,516000,983215,0
CA,Concorde Career College,982367,0,0,982367,0
CA,Southwestern Law School,212120,269763,499000,980883,0
NJ,Pennco Tech,979653,0,0,979653,0
IL,Fox College,979641,0,0,979641,0
MI,Great Lakes Christian College,159906,298456,518000,976362,0
PR,Instituto Educativo Premier,974349,0,0,974349,0
IL,Coalition Of African American Nurses,125975,244318,604000,974293,0
NV,Career College Of Northern Nevada,974259,0,0,974259,0
CA,Gemological Institute Of America,176142,251997,543000,971139,0
WA,Digipen Institute Of Technology,961951,0,0,961951,0
PR,Inter American University Of Puerto Rico - School Of Law,193606,269630,498000,961236,0
WV,Garnet Career Center,148515,296103,514000,958618,0
OH,Alliance Career Center,108179,269624,579000,956803,0
PA,Upmc Mercy School Of Nursing,175624,284016,496000,955640,0
IL,Illinois Media School,954313,0,0,954313,0
CA,Touro University Worldwide,87768,313122,551000,951890,0
SC,Kenneth Shuler School Of Cosmetology & Nails,951470,0,0,951470,0
OH,Ohio Business College,948103,0,0,948103,0
PR,Century College,947701,0,0,947701,0
CO,Collegeamerica Denver,944384,0,0,944384,0
AK,Alaska Career College,941040,0,0,941040,0
TX,Criswell College,152588,286200,501000,939788,0
NY,Ohr Hameir Theological Seminary,184006,275552,479000,938558,0
WA,International Air & Hospitality Academy,936798,0,0,936798,0
PA,Pitc Institute,936629,0,0,936629,0
PR,Academia Serrant,936113,0,0,936113,0
MA,Southeastern Regional Vocational Technical School,156398,277315,502000,935713,0
IL,Morrison Institute Of Technology,180060,275067,480000,935127,0
AR,Ecclesia College,148173,273519,508000,929692,0
NC,Health And Style Institute,927846,0,0,927846,0
MO,Franklin Technology Center,202194,261263,464000,927457,0
MT,Aaniiih Nakoda College,114359,295974,517000,927333,0
CA,California Western School Of Law,196710,256504,474000,927214,0
AZ,Conservatory Of Recording Arts & Sciences,926993,0,0,926993,0
PA,Chester County Intermediate Unit Practical Nursing Program,158967,280350,487000,926317,0
OK,Caddo-Kiowa Area Vocational-Technical School District No. 2,169573,272152,484000,925725,0
WA,Faith International University,162349,274839,488000,925188,0
MN,Red Lake Nation College,151473,282627,491000,925100,0
PA,Career Technology Center Of Lackawanna County,174002,274681,476000,924683,0
MI,Compass College Of Cinematic Arts,186951,267935,468000,922886,0
WI,Lac Courte Oreilles Ojibwe College,31226,125237,765000,921463,0
CA,Bellus Academy,915623,0,0,915623,0
CO,Technical College Of The Rockies,128974,280929,505000,914903,0
CA,Milan Institute,914326,0,0,914326,0
MA,Franklin W. Olin College Of Engineering,178424,263423,471000,912847,0
NY,Yeshiva D'Monsey,182423,266255,463000,911678,0
NY,Rabbinical College Ohr Yisroel,176604,267738,465000,909342,0
CA,Diversified Vocational College,908774,0,0,908774,0
FL,Cortiva Institute,908597,0,0,908597,0
PA,Eastern Center For Arts And Technology-Practical Nursing,157939,263505,486000,907444,0
NY,Yeshiva Shaar Ephraim,175684,266626,463000,905310,0
WV,Salem University,904789,0,0,904789,0
OH,Warren County Career Center,107854,256031,539000,902885,0
WA,Evergreen Beauty And Barber College,902623,0,0,902623,0
CA,Southern California Health Institute (Sochi),902290,0,0,902290,0
NJ,Eastwick College,895753,0,0,895753,0
NY,Mirrer Yeshiva Central Institute,156376,268703,469000,894079,0
NY,Yeshivas Maharit D'Satmar,174514,263183,456000,893697,0
NJ,Yeshiva Gedola Tiferes Yerachmiel,179422,260236,453000,892658,0
NE,Little Priest Tribal College,144184,272758,475000,891942,0
OK,Red River Technology Center School District 19,156175,263657,471000,890832,0
CA,Concorde Career College,887365,0,0,887365,0
HI,Pacific Rim Christian University,156569,266359,464000,886928,0
MO,Texas County Technical Institute,155166,263542,468000,886708,0
OH,Cleveland Institute Of Music (The),186268,250323,450000,886591,0
AR,Imagine - Paul Mitchell Partner School,883707,0,0,883707,0
KY,Beckfield College,881109,0,0,881109,0
NY,Rabbinical College Of Long Island,170473,258635,452000,881108,0
OR,University Of Western States,164488,251335,465000,880823,0
AL,Alabama College Of Osteopathic Medicine,186805,242819,449000,878624,0
CA,Keck Graduate Institute Of Applied Life Sciences,189117,241924,447000,878041,0
OH,Dayton School Of Medical Massage,875986,0,0,875986,0
CA,Sae Expression College,875264,0,0,875264,0
CA,Marshall B. Ketchum University,145778,255280,472000,873058,23988000
OH,Eastland-Fairfield Career And Technical Schools,133125,230759,509000,872884,0
OH,Antioch College,164109,258673,449000,871782,0
NY,American Academy Mcallister Institute,93366,283171,495000,871537,0
CA,University Of The West,140086,263934,467000,871020,0
TX,Arlington Baptist University,151631,262372,457000,871003,0
MO,Southeast Missouri Hospital College Of Nursing And Health Sciences,131509,266731,470000,868240,0
PR,San Juan Bautista School Of Medicine,173235,249830,445000,868065,0
KS,Kansas Christian College,117258,273937,476000,867195,0
IN,Saint Elizabeth School Of Nursing,136328,266111,464000,866439,0
WV,Cabell County Career Technology Center,160620,257572,447000,865192,0
PA,Delaware County Technical School,150255,261376,453000,864631,0
TX,Texas Barber College,863797,0,0,863797,0
CA,Life Chiropractic College West,171227,242238,448000,861465,0
CA,Concorde Career College,861408,0,0,861408,0
NY,Five Towns College,860147,0,0,860147,0
OH,Canton City School District Adult Career & Technical Education,181545,247976,430000,859521,0
CA,Concorde Career College,857787,0,0,857787,0
NY,Davis College,135671,262894,459000,857565,0
FL,South Florida Bible College And Theological Seminary,96848,281055,478000,855903,0
CA,Musicians Institute,854505,0,0,854505,0
WV,James Rumsey Technical Institute,138292,261029,455000,854321,0
MI,Kuyper College,166221,249551,436000,851772,0
NV,Advanced Training Institute,850047,0,0,850047,0
VA,Bon Secours Memorial College Of Nursing,141069,254185,452000,847254,0
GA,Georgia Career Institute,846937,0,0,846937,0
OH,Ashtabula County Technical And Career Campus,124546,222067,499000,845613,0
NJ,Eastwick College - Hackensack Campus.,844520,0,0,844520,0
IA,St. Luke'S College,136761,256703,449000,842464,0
MN,White Earth Tribal And Community College,105200,269057,467000,841257,0
NY,Rabbinical Academy Mesivta Rabbi Chaim Berlin,168667,240703,428000,837370,0
TN,American Baptist Theological Seminary,152145,250134,434000,836279,0
OK,Southwest Technology Center School District # 27,113543,261363,460000,834906,0
DC,Prospect College,830854,0,0,830854,0
PR,Professional Technical Institution,827459,0,0,827459,0
DE,Delaware College Of Art And Design,168154,239395,417000,824549,0
FL,North Florida Technical College,134851,249666,438000,822517,0
CA,Abc Adult School,133978,210313,478000,822291,0
IL,Trinity College Of Nursing & Health Sciences,127554,251781,441000,820335,0
OH,American Institute Of Alternative Medicine,818622,0,0,818622,0
TX,Amberton University,135514,241006,441000,817520,0
NY,New York School Of Interior Design,117250,250094,450000,817344,0
OK,Green Country Technology Center,157598,237307,421000,815905,0
PR,Emma'S Beauty Academy,814149,0,0,814149,0
IL,Illinois College Of Optometry,174875,223171,413000,811046,0
MD,Cortiva Institute,809235,0,0,809235,0
PA,Western Area Career & Technology Center,123771,191591,493000,808362,0
MT,Chief Dull Knife College,103368,254495,450000,807863,0
NY,Phillips School Of Nursing At Mount Sinai Beth Israel,151193,236544,419000,806737,0
OH,Cuyahoga Valley Career Center,164195,234082,407000,805277,0
FL,Nouvelle Institute,805020,0,0,805020,0
CA,South Baylo University,213732,227872,361000,802604,0
OH,Ohio Institute Of Allied Health,101503,254527,446000,802030,0
OR,Institute Of Technology,799110,0,0,799110,0
FL,Aveda Institute - Tallahassee,798287,0,0,798287,0
PA,South Hills School Of Business & Technology,795265,0,0,795265,0
MA,Bay State College,794883,0,0,794883,0
PA,Fortis Institute,791394,0,0,791394,0
AR,Jrmc School Of Nursing,142391,233208,415000,790599,0
CO,Denver Seminary,137773,228720,423000,789493,0
NC,Carolina College Of Biblical Studies,119702,243633,424000,787335,0
CA,Santa Barbara Business College,786894,0,0,786894,0
NY,Cuny School Of Law '(The)',141995,225396,417000,784391,0
NJ,Pc Age,782767,0,0,782767,0
FL,Aviation Institute Of Maintenance,782346,0,0,782346,0
PA,Somerset County Technology Center,139358,234539,407000,780897,0
FL,Cambridge Institute Of Allied Health And Technology,779045,0,0,779045,0
NY,Yeshiva Sholom Shachna,153086,228120,397000,778206,0
TX,Baptist University Of The Americas,122224,238328,416000,776552,0
OH,Paul Mitchell The School Cincinnati,776215,0,0,776215,0
IL,Lakeview College Of Nursing,140717,230720,404000,775437,0
FL,Miami Regional University,774452,0,0,774452,0
FL,Paul Mitchell The School-Jacksonville,773577,0,0,773577,0
OK,Oklahoma State University Center For Health Sciences,144134,220100,407000,771234,0
WA,Academy Of Interactive Entertainment,140430,229333,401000,770763,0
UT,Neumont College Of Computer Science,769673,0,0,769673,0
WA,Pacific Northwest University Of Health Sciences,166437,211659,391000,769096,0
PR,Industrial Technical College,768357,0,0,768357,0
PR,"Liceo De Arte, Diseños Y Comercio",767805,0,0,767805,0
PA,Western Pennsylvania Hospital School Of Nursing,141885,223212,401000,766097,0
OK,Pontotoc Technology Center District #14,145011,212946,407000,764957,0
VT,Vermont Law School,151393,215512,398000,764905,0
AK,Alaska Vocational Technical Center,71437,252317,441000,764754,0
VT,Sterling College,129712,228347,404000,762059,0
CO,Rocky Mountain College Of Art + Design,761314,0,0,761314,0
TX,Ucas University Of Cosmetology Arts & Sciences,760609,0,0,760609,0
AZ,University Of Advancing Computer Technology,759682,0,0,759682,0
NY,Elim Bible Institute And College,151944,221373,386000,759317,0
FL,Miami Media School,757634,0,0,757634,0
PA,Geisinger Commonwealth School Of Medicine,160035,209453,387000,756488,0
OH,Auburn Career Center,124034,228775,402000,754809,0
CO,Denver College Of Nursing,753229,0,0,753229,0
OH,Bradford School,752083,0,0,752083,0
CA,Paul Mitchell The School Sacramento,750351,0,0,750351,0
CA,Premiere Career College,747470,0,0,747470,0
MA,New England College Of Optometry (The),163236,204223,378000,745459,0
ID,Paul Mitchell The School Boise,740779,0,0,740779,0
LA,Vanguard College Of Cosmetology A Paul Mitchell Partner School-Metaire,736592,0,0,736592,0
OK,Eastern Oklahoma County Technology Center School District #23,114478,218825,397000,730303,0
CA,Wright Institute (The),145487,204327,378000,727814,0
PA,Laurel Technical Institute,727647,0,0,727647,0
PA,Venango County Area Vocational Technical School,134117,197655,395000,726772,0
NJ,Yeshivas Be'Er Yitzchok,139993,214403,372000,726396,0
CA,Paul Mitchell The School Temecula,725475,0,0,725475,0
NY,Yeshiva Of The Telshe Alumni,139972,212344,371000,723316,0
TX,Rio Grande Valley College,722800,0,0,722800,0
CA,Epic Bible College,93800,227409,400000,721209,0
TN,Southern College Of Optometry,156253,197963,366000,720216,0
PA,Indiana County Technology Center,131498,214580,373000,719078,0
DC,Wesley Theological Seminary,142919,201191,372000,716110,0
CA,Sum Bible College & Theological Seminary,26609,249266,437000,712875,0
SC,Arclabs,712771,0,0,712771,0
IN,Tricoci University Of Beauty Culture,711717,0,0,711717,0
OH,Trumbull Career And Technical Center-Adult Training Center,112359,190643,407000,710002,0
FL,Cortiva Institute,709623,0,0,709623,0
ID,Boise Bible College,130055,211493,368000,709548,0
AL,Huntsville Bible College,96521,223392,388000,707913,0
NY,Beth Hamedrash Shaarei Yosher Institute,133173,209184,363000,705357,0
UT,Ameritech College,705243,0,0,705243,0
WV,Mercer County Technical Education Center,105541,213047,385000,703588,0
MI,Specs Howard School Of Media Arts,702843,0,0,702843,0
CA,Cogswell Polytechnical College,701472,0,0,701472,0
GA,Morehouse School Of Medicine,147523,193537,358000,699060,0
FL,Hci College,698258,0,0,698258,0
MA,Motoring Technical Training Institute,698220,0,0,698220,0
NY,Madison Oneida Boces Practical Nursing Program,89648,178563,430000,698211,0
PA,Aviation Institute Of Maintenance,698192,0,0,698192,0
OH,Madison Adult Career Center,110102,210003,373000,693105,0
OR,New Hope Christian College,127250,206731,359000,692981,0
TN,Genesis Career College,692917,0,0,692917,0
OH,Creative Images Institute Of Cosmetology,692021,0,0,692021,0
NY,Swedish Institute,691142,0,0,691142,0
HI,Hawaii Medical College,690676,0,0,690676,0
MS,Southeastern Baptist College,73845,225049,390000,688894,0
MA,New England Law | Boston,148978,188842,349000,686820,0
NY,Bank Street College Of Education,124021,197364,365000,686385,49109000
MD,Hair Academy,685979,0,0,685979,0
AR,Champion Christian College,87078,218514,379000,684592,0
PR,Educational Technical College (Edutec),682212,0,0,682212,0
TX,Culinary Institute Lenotre,682153,0,0,682153,0
NE,Nebraska Indian Community College,77576,219271,385000,681847,0
CA,Alliant International University,679282,0,0,679282,0
NY,Yeshiva Shaarei Torah Of Rockland,136261,197398,345000,678659,0
IL,Macmurray College,677656,0,0,677656,0
FL,American Institute Of Beauty,676204,0,0,676204,0
FL,Aveda Institute - South Florida,676153,0,0,676153,0
PA,Great Lakes Institute Of Technology,675003,0,0,675003,0
NJ,Parisian Beauty Academy Paul Mitchell Partner School,673639,0,0,673639,0
OH,Ohio Technical College,671034,0,0,671034,0
MN,Oak Hills Christian College,111319,204257,355000,670576,0
WI,Columbia College Of Nursing,121544,199456,348000,669000,0
PA,Pennco Tech,667974,0,0,667974,0
FL,Praxis Institute,663998,0,0,663998,0
OH,Buckeye Career Center,118342,198159,344000,660501,0
GU,Pacific Islands University,120440,197531,342000,659971,0
NY,Herkimer County Boces Practical Nursing Program,117344,197198,342000,656542,0
NY,Yeshiva Derech Chaim,128724,191008,335000,654732,0
SC,Sherman College Of Straight Chiropractic,136466,181651,336000,654117,0
NY,Samaritan Hospital School Of Nursing,110633,197013,343000,650646,0
UT,Paul Mitchell The School Salt Lake City,647756,0,0,647756,0
PR,Escuela Técnica De Electricidad,644003,0,0,644003,0
NY,Montefiore School Of Nursing,94873,199194,349000,643067,0
MD,Bais Hamedrash And Mesivta Of Baltimore,124132,187848,326000,637980,0
NY,"Monroe 2 - Orleans Boces, Center For Workforce Development",92085,197197,344000,633282,0
OR,Sumner College,632989,0,0,632989,0
NY,Albany Law School Of Union University,117773,180629,334000,632402,0
TX,Aviation Institute Of Maintenance,631206,0,0,631206,0
MA,Upper Cape Cod Regional Technical School,120421,180192,330000,630613,0
CA,Hypnosis Motivation Institute,56543,136342,437000,629885,0
WV,Putnam Career & Technical Center,106383,190673,332000,629056,0
OK,Wes Watkins Technology Center School District #25,87161,185876,356000,629037,0
IL,Paul Mitchell The School Chicago,626698,0,0,626698,0
TX,Peloton College,626237,0,0,626237,0
MA,National Aviation Academy - New England,625133,0,0,625133,0
VT,Vermont College Of Fine Arts,142286,169130,313000,624416,0
OR,Concorde Career College,623986,0,0,623986,0
FL,Florida Vocational Institute,623164,0,0,623164,0
FL,Concorde Career Institute,621612,0,0,621612,0
SC,Kenneth Shuler School Of Cosmetology,620853,0,0,620853,0
NC,Carolina Christian College,114861,184859,321000,620720,0
OH,Felbry College-School Of Nursing,617396,0,0,617396,0
PA,Franklin County Career And Technology Center,89503,190443,337000,616946,0
OH,Cincinnati College Of Mortuary Science,134679,175892,306000,616571,0
OH,Upper Valley Career Center,73618,197763,343000,614381,0
MO,Grand River Technical School,113559,182186,317000,612745,0
SC,Kenneth Shuler School Of Cosmetology & Hair Design,611571,0,0,611571,0
NJ,Talmudical Academy,122458,178092,310000,610550,0
NJ,Harris School Of Business,609828,0,0,609828,0
VA,Columbia College,609412,0,0,609412,168869000
NJ,Princeton Theological Seminary,143741,163528,302000,609269,1127362000
IL,Hebrew Theological College,107582,181465,319000,608047,0
TN,Nossi College Of Art,606694,0,0,606694,0
NC,Southeastern Institute,605946,0,0,605946,0
PA,Mifflin County Academy Of Science And Technology,117767,177636,310000,605403,0
NY,Yeshivas Novominsk,163597,160631,281000,605228,0
NY,Yeshiva Gedolah Kesser Torah,115347,177692,310000,603039,0
CA,Associated Technical College,602768,0,0,602768,0
CO,Aveda Institute Denver,602184,0,0,602184,0
FL,New Professions Technical Institute,600447,0,0,600447,0
GA,Georgia Institute Of Cosmetology,599634,0,0,599634,0
OH,Aveda Institute Columbus,599625,0,0,599625,0
CA,Tri-Community Adult Education,68720,170637,360000,599357,0
NY,New York Automotive & Diesel Institute,598781,0,0,598781,0
AZ,Aveda Institute Tucson,598691,0,0,598691,0
CA,Unitek College,598178,0,0,598178,0
OH,Portage Lakes Career Center,106470,179039,312000,597509,0
NC,Paul Mitchell The School Gastonia,595930,0,0,595930,0
CT,Porter And Chester Institute Of Hamden,595156,0,0,595156,0
OK,"High Plains Technology Center, School District No. 24",54421,194173,346000,594594,0
NY,New Age Training,594376,0,0,594376,0
OR,Western Seminary,100084,172607,319000,591691,0
CA,Laurus College,591076,0,0,591076,0
CA,National Career College,589577,0,0,589577,0
CO,Auguste Escoffier School Of Culinary Arts,588381,0,0,588381,0
CT,Branford Hall Career Institute,588348,0,0,588348,0
PA,Talmudical Yeshiva Of Philadelphia,111069,156403,320000,587472,0
MA,North Bennet Street School,119089,162637,304000,585726,0
CA,American Jewish University,111218,170995,302000,584213,0
NH,St. Joseph Hospital Of Nashua N.H.D/B/A St. Joseph School Of Nursing,96027,176727,311000,583754,0
OH,Trinity Health System School Of Nursing,99922,176816,307000,583738,0
GA,Woodruff Medical Training And Testing,583499,0,0,583499,0
LA,Baton Rouge General Medical Center,69310,186886,326000,582196,0
IL,Cosmetology And Spa Academy,582054,0,0,582054,0
NY,Broome Delaware Tioga Boces Program Of Practical Nursing,94163,147601,340000,581764,0
CA,Blake Austin College,581595,0,0,581595,0
WV,Fayette Institute Of Technology,106163,160267,314000,580430,0
NY,Jamestown Business College,577492,0,0,577492,0
FL,Hobe Sound Bible College,75745,173384,328000,577129,0
CA,Marian Health Careers Center,575634,0,0,575634,0
PA,Penn Commercial Business/Technical School,575574,0,0,575574,0
NY,Southern Westchester Boces,92799,173278,307000,573077,0
NJ,Yeshiva Chemdas Hatorah,112892,167282,291000,571174,0
MI,Saginaw Chippewa Tribal College,83912,176488,309000,569400,0
NY,Orange Ulster Boces School Of Practical Nursing,97357,170810,301000,569167,0
PR,Nova College Of Puerto Rico,568986,0,0,568986,0
NC,School Of Communication Arts Of North Carolina,568133,0,0,568133,0
PA,Westminster Theological Seminary,96630,165242,306000,567872,0
NY,Cochran School Of Nursing Saint John'S Riverside Hosp,86672,174690,304000,565362,0
CA,Mayfield College,564629,0,0,564629,0
PA,Schuylkill Technology Centers,106526,161766,294000,562292,0
CA,Pacific College Of Oriental Medicine,561804,0,0,561804,0
FL,Concorde Career Institute,561628,0,0,561628,0
PR,Emma'S Beauty Academy,561434,0,0,561434,0
NY,Career School Of Ny,74214,178126,309000,561340,0
NY,St. Peter'S Hospital College Of Nursing,84543,172938,302000,559481,0
NJ,Beth Medrash Of Asbury Park,109145,164258,286000,559403,0
TX,Vogue College Of Cosmetology,558728,0,0,558728,0
FL,Florida Education Institute,558247,0,0,558247,0
LA,Crescent City School Of Gaming & Bartending,557634,0,0,557634,0
PA,Vet Tech Institute,556560,0,0,556560,0
MO,Carthage R-9 School District/Carthage Technical Center,96621,168356,291000,555977,0
FL,English Center (The),91968,162784,301000,555752,0
NJ,Harris School Of Business,554114,0,0,554114,0
CA,Paul Mitchell The School Modesto,553609,0,0,553609,0
CA,Newschool Of Architecture And Design,553090,0,0,553090,0
CA,Moler Barber College,551182,0,0,551182,0
NY,Orleans Niagara Boces,113519,160272,277000,550791,0
PA,Central Penn College,550693,0,0,550693,0
CA,Paul Mitchell The School Fresno,550245,0,0,550245,0
NY,Suny College Of Optometry,118717,151252,280000,549969,0
CA,Milan Institute,549033,0,0,549033,0
WA,Divers Institute Of Technology,548712,0,0,548712,0
CA,Lu Ross Academy,547287,0,0,547287,0
PR,Myrangel Beauty Institute,546026,0,0,546026,0
CA,Toni&Guy Hairdressing Academy,545266,0,0,545266,0
CA,Salon Success Academy,543888,0,0,543888,0
PA,Fortis Institute,542910,0,0,542910,0
NY,Jewish Theological Seminary Of America (The),118674,147972,276000,542646,0
IL,Illinois Eastern Community Colleges - Wabash Valley College,541848,0,0,541848,0
NJ,Bais Medrash Toras Chesed,68038,171733,302000,541771,0
FL,Artistic Nails & Beauty Academy,541307,0,0,541307,0
DE,Dawn Career Institute,539645,0,0,539645,0
KY,Pj'S College Of Cosmetology,539531,0,0,539531,0
CO,Spartan College Of Aeronautics And Technology,539465,0,0,539465,0
LA,Medical Training College,539363,0,0,539363,0
CA,Bellus Academy,539166,0,0,539166,0
CA,Federico Beauty Institute,538895,0,0,538895,0
TX,Mediatech Institute,538457,0,0,538457,0
IL,St. John'S College,100955,156367,280000,537322,217294000
NY,Rockland County Boces Adult Education,104744,158385,274000,537129,0
IL,Verve College,537056,0,0,537056,0
NJ,Union County Vocational Technical Schools,100104,153054,280000,533158,0
TX,Baptist Health System School Of Health Professions,531618,0,0,531618,0
PA,Triangle Tech,530918,0,0,530918,0
AZ,Southwest College Of Naturopathic Medicine & Health Sciences,114934,145960,270000,530894,0
VA,Aviation Institute Of Maintenance,530011,0,0,530011,0
NH,Magdalen College,103591,155397,271000,529988,0
MD,Temple (The): A Paul Mitchell Partner School,528840,0,0,528840,0
WI,Shepherds College,99604,155176,270000,524780,0
MO,Academy Of Hair Design,524704,0,0,524704,0
PA,Erie Institute Of Technology,519694,0,0,519694,0
TX,Northwest Educational Center,519264,0,0,519264,0
NY,New York College Of Podiatric Medicine,115225,141984,262000,519209,0
NH,Thomas More College Of Liberal Arts,102524,151166,264000,517690,0
VA,"Standard Healthcare Services, College Of Nursing",516309,0,0,516309,0
MI,Sacred Heart Major Seminary,74193,156719,285000,515912,0
CA,Aviation Institute Of Maintenance,512166,0,0,512166,0
ND,Nueta Hidatsa Sahnish College,83694,157142,270000,510836,0
MI,Yeshiva Gedolah Of Greater Detroit,100742,149742,260000,510484,0
WV,Benjamin Franklin Career & Technical Center,96740,132653,280000,509393,0
LA,Academy Of Interactive Entertainment,88545,153694,267000,509239,0
NY,Hebrew Union College - Jewish Institute Of Religion,104168,141966,262000,508134,0
MA,Hellenic College & Holy Cross Greek Orthodox School Of Theology,111043,143030,254000,508073,0
LA,Saint Joseph Seminary College,98377,145762,263000,507139,0
TX,Quest College,506799,0,0,506799,0
WV,West Virginia Junior College,506663,0,0,506663,0
GA,Omnitech Institute,506117,0,0,506117,0
CA,Career Networks Institute,505137,0,0,505137,0
VA,Virginia University Of Integrative Medicine,79436,149419,276000,504855,0
OK,Central Oklahoma College,504384,0,0,504384,0
MO,Aviation Institute Of Maintenance,503111,0,0,503111,0
ME,Spa Tech Institute,502984,0,0,502984,0
TX,Vet Tech Institute Of Houston,502030,0,0,502030,0
IL,Midwestern Career College,501791,0,0,501791,0
KY,American National University,501696,0,0,501696,0
WV,Monongalia County Technical Education Center (Mtec),93681,148572,259000,501253,0
FL,Atlantic Institute Of Oriental Medicine,130647,129468,239000,499115,0
MO,Covenant Theological Seminary,88666,144086,266000,498752,0
PA,Beauty Institute (The),497279,0,0,497279,0
IA,Waldorf University,497220,0,0,497220,0
NJ,National Career Institute,497128,0,0,497128,0
IN,Mycomputercareer.Com /Techskills,495594,0,0,495594,0
CA,Cinta Aveda Institute,493584,0,0,493584,0
NJ,Bergen County Technical Schools,76107,149957,266000,492064,0
NY,Amg School Of License Practical Nursing,491430,0,0,491430,0
CA,Empire College,490975,0,0,490975,0
FL,Hollywood Institute,490367,0,0,490367,0
NJ,Teterboro School Of Aeronautics,490330,0,0,490330,0
FL,Meridian College,488558,0,0,488558,0
MA,Greater Lowell Regional Vocational Technical School,94030,134707,259000,487737,0
MA,Massachusetts School Of Law At Andover,110861,131604,243000,485465,0
NY,Jefferson Lewis Boces Program Of Practical Nursing,105234,138888,241000,485122,0
PA,Triangle Tech,484941,0,0,484941,0
GA,Paul Mitchell The School Atlanta,484422,0,0,484422,0
TX,Texas College Of Cosmetology,483500,0,0,483500,0
NJ,Hohokus School Of Trade And Technical Sciences,483327,0,0,483327,0
PA,Clearfield County Career And Technology Center,87950,136055,257000,481005,0
MO,Pike Lincoln Technical Center,67332,107217,305000,479549,0
VA,Advanced Technology Institute,479439,0,0,479439,0
NY,Beis Medrash Heichal Dovid,96883,137156,242000,476039,0
MD,Maryland University Of Integrative Health,91890,134889,249000,475779,0
CO,International Salon And Spa Academy,475449,0,0,475449,0
MI,Keweenaw Bay Ojibwa Community College,68566,148467,258000,475033,0
SC,Southeastern Institute,473641,0,0,473641,0
CA,Mount Diablo Adult Education,68958,140698,263000,472656,0
OH,Allegheny Wesleyan College,83992,141323,246000,471315,0
MD,Hair Expressions Academy,470791,0,0,470791,0
CO,Bel - Rea Institute Of Animal Technology,470581,0,0,470581,0
WV,West Virginia Junior College,470415,0,0,470415,0
CA,American Film Institute Conservatory,98640,130412,241000,470052,0
NY,Mechon L'Hoyroa,91885,138220,239000,469105,0
VA,Henrico County-Saint Mary'S Hospital School Of Practical Nursing,110429,127210,231000,468639,0
NC,Grace College Of Divinity,71597,143192,251000,465789,0
TX,Cybertex Institute Of Technology,465548,0,0,465548,0
MO,Saint Luke'S College Of Health Sciences,462823,0,0,462823,0
NV,Paul Mitchell The School Las Vegas,462659,0,0,462659,0
OR,Aveda Institute Portland,461109,0,0,461109,0
NV,Aveda Institute Las Vegas,458983,0,0,458983,0
TX,Commonwealth Institute Of Funeral Service,64090,143732,251000,458822,0
CA,Advance Beauty College,458495,0,0,458495,0
GA,Grady Health System,90793,133510,234000,458303,0
NY,New York School For Medical & Dental Assistants,457757,0,0,457757,0
PA,Susquehanna County Career & Technology Center,53535,91598,312000,457133,0
IA,Pci Academy,454747,0,0,454747,0
NC,Watts College Of Nursing,42191,55179,355000,452370,0
OH,Athena Career Academy,451504,0,0,451504,0
FL,Treasure Coast Technical College,53915,142662,254000,450577,0
OK,"Northwest Technology Center, School District 10",85786,130181,234000,449967,0
MA,Diman Regional Vocational Technical Institute,81241,134391,234000,449632,0
IL,Telshe Yeshiva-Chicago,86628,131342,230000,447970,0
WA,Paul Mitchell The School Richland,447875,0,0,447875,0
FL,D. A. Dorsey Technical College,51116,143641,253000,447757,0
CA,Central Coast College,447424,0,0,447424,0
CA,World Mission University,52382,142130,252000,446512,0
CA,Paul Mitchell The School Sherman Oaks,446039,0,0,446039,0
PA,Walnut Hill College,445337,0,0,445337,0
MN,Aveda Institute Minneapolis,445074,0,0,445074,0
NY,Elyon College,79445,124036,241000,444481,0
UT,Provo College,443357,0,0,443357,0
FL,Fort Pierce Beauty Academy,443123,0,0,443123,0
PA,Saint Charles Borromeo Seminary,62584,135207,245000,442791,0
FL,Compu-Med Vocational Careers,442546,0,0,442546,0
OH,United Theological Seminary,80709,126438,234000,441147,0
NY,National Tractor Trailer School,439995,0,0,439995,0
NJ,Yeshiva Gedolah Tiferes Boruch,86883,128806,224000,439689,0
CA,Grace Mission University,61227,136645,241000,438872,0
OH,Raphael'S School Of Beauty Culture,438150,0,0,438150,0
IL,Tricoci University Of Beauty Culture,436904,0,0,436904,0
OR,Oregon College Of Oriental Medicine,100095,117968,218000,436063,0
PA,Jolie Health And Beauty Academy,435974,0,0,435974,0
IL,Tricoci University Of Beauty Culture,435780,0,0,435780,0
NY,Clinton-Essex-Warren-Washington Boces,82722,128983,224000,435705,0
PR,Bayamon Community College,435133,0,0,435133,0
CA,Salon Success Academy,434633,0,0,434633,0
IL,Eti School Of Skilled Trades,434609,0,0,434609,0
IL,Illinois Eastern Community Colleges - Lincoln Trail College,434306,0,0,434306,0
MA,Blue Hills Regional Technical School,84964,127079,221000,433043,0
VA,Chester Career College,431590,0,0,431590,0
MN,Luther Seminary,74012,125262,232000,431274,108716000
AR,Career Academy Of Hair Design,429737,0,0,429737,0
TN,Gould'S Academy,429649,0,0,429649,0
DC,Bennett Career Institute,429212,0,0,429212,0
FL,University Of Fort Lauderdale,61344,134315,233000,428659,0
OH,Ohio Valley College Of Technology,428200,0,0,428200,0
MO,Wellspring School Of Allied Health,428142,0,0,428142,0
PA,Washington Hospital (The),75704,127547,224000,427251,0
WV,Ralph R Willis Career And Technical Center,73861,105807,247000,426668,0
PR,Modern Hairstyling Institute,426601,0,0,426601,0
MO,Paul Mitchell The School Springfield,426043,0,0,426043,0
AK,Ilisagvik College,36806,136862,248000,421668,0
NJ,Yeshiva Gedolah Shaarei Shmuel,85372,121986,214000,421358,0
ID,Oliver Finley Academy Of Cosmetology,420835,0,0,420835,0
DC,Career Technical Institute,420528,0,0,420528,0
WA,Gene Juarez Beauty Schools,420399,0,0,420399,0
CA,Thomas Jefferson School Of Law,116684,106572,197000,420256,0
ME,Beal College,419913,0,0,419913,0
VA,Culpeper Cosmetology Training Center,83682,119538,213000,416220,0
GA,Paul Mitchell The School - Esani,415434,0,0,415434,0
GA,Elaine Sterling Institute(The),414178,0,0,414178,0
OH,Mycomputercareer.Com /Techskills,414059,0,0,414059,0
PA,Curtis Institute Of Music,86460,114363,213000,413823,253189000
NJ,Monmouth County Vocational School District,60651,128717,224000,413368,0
MA,Assabet Valley Regional Vocational School,82100,120106,211000,413206,0
FL,Boca Beauty Academy,412160,0,0,412160,0
CO,Platt College,412152,0,0,412152,0
AZ,Penrose Academy,412035,0,0,412035,0
NH,New England College,411295,0,0,411295,14646000
GA,Pro Way Hair School,408553,0,0,408553,0
MI,Western Michigan University Homer Stryker M.D. School Of Medicine,78563,115890,214000,408453,0
FL,Bene'S Career Academy,406818,0,0,406818,0
CA,Icohs College,41928,119635,243000,404563,0
FL,Aparicio-Levy Technical College,45310,126999,231000,403309,0
OH,Northcoast Medical Training Academy,402690,0,0,402690,0
ID,Paul Mitchell The School Rexburg,401899,0,0,401899,0
VA,Aviation Institute Of Maintenance,401732,0,0,401732,0
NY,Ulster County Boces School Of Practical Nursing,76934,110102,214000,401036,0
MO,Saint Louis Christian College,59391,124410,217000,400801,0
NY,Arnot Ogden Medical Center,79464,117203,204000,400667,0
IN,Aviation Institute Of Maintenance,400623,0,0,400623,0
NJ,Robert Fiance Beauty Schools,400511,0,0,400511,0
NY,Cattaraugus/Allegany/Erie/Wyoming Boces,58802,122681,217000,398483,0
GA,Luther Rice College & Seminary,23030,135831,239000,397861,0
IN,Tricoci University Of Beauty Culture,396317,0,0,396317,0
NY,"Ellis Medicine, The Belanger School Of Nursing",78739,115012,202000,395751,0
UT,Eagle Gate College,395657,0,0,395657,0
PA,Triangle Tech,394320,0,0,394320,0
PA,Northern Tier Career Center,73110,117063,204000,394173,0
IL,Lake Forest Graduate School Of Management,62548,116332,215000,393880,0
CA,North-West College,393842,0,0,393842,0
DE,Polytech Adult Education,47434,123421,222000,392855,0
TX,Arlington Career Institute,391614,0,0,391614,0
PA,Douglas Education Center,391261,0,0,391261,0
TX,Avenue Five Institute,391249,0,0,391249,0
PA,St Margaret Memorial Hospital School Of Nursing,91302,108816,191000,391118,0
IL,First Institute,390859,0,0,390859,0
FL,Florida Barber Academy,390387,0,0,390387,0
MO,Midwest Institute,389911,0,0,389911,0
MO,Clinton Technical School,75280,113774,200000,389054,0
CA,International School Of Beauty,386363,0,0,386363,0
NY,Ailey School (The),76403,111889,197000,385292,0
CA,American University Of Health Sciences,384752,0,0,384752,0
WV,Huntington Junior College Of Business,384451,0,0,384451,0
UT,Taylor Andrews Academy Of Hair Design,383197,0,0,383197,0
AR,Arkansas Colleges Of Health Education,47138,117888,218000,383026,0
MI,David Pressley Professional School Of Cosmetology,382850,0,0,382850,0
TX,Southwest School Of Business & Technical Careers,381421,0,0,381421,0
TN,"Chattanooga College - Medical, Dental And Technical Careers",381353,0,0,381353,0
IA,Hamilton Technical College,380408,0,0,380408,0
CA,Butte County Regional Occupational Program,60515,116551,203000,380066,0
NE,Joseph'S College Cosmetology,379798,0,0,379798,0
OH,Ashland County - West Holmes Career Center - Adult Education,76818,110664,192000,379482,0
WV,Mingo Extended Learning Center,59512,108657,211000,379169,0
OH,Tdds Technical Institute,379013,0,0,379013,0
VA,"Rudy & Kelly Academy, A Paul Mitchell Partner School",378939,0,0,378939,0
SC,Academy For Careers And Technology,64795,114788,199000,378583,0
MO,Kirksville Area Technical Center,47216,86135,245000,378351,0
PA,Joseph F. Mccloskey School Of Nursing At Schuylkill Health,82249,107659,188000,377908,0
NV,Academy Of Hair Design,375960,0,0,375960,0
MI,Taylortown School Of Beauty,375859,0,0,375859,0
MN,Minnesota School Of Cosmetology,375857,0,0,375857,0
NY,New York College Of Traditional Chinese Medicine,84673,102149,189000,375822,0
NY,New York Medical Career Training Center,375729,0,0,375729,0
OH,Lorain County Jvs Adult Career Center,35237,115755,224000,374992,0
FL,Futura Career Institute,374889,0,0,374889,0
KY,Kentucky Mountain Bible College,68799,111533,194000,374332,0
IL,Tricoci University Of Beauty Culture,373874,0,0,373874,0
TX,Aveda Arts & Sciences Institute Corpus Christi,373504,0,0,373504,0
TX,Wade Gordon Hairdressing Academy,373069,0,0,373069,0
OR,Phagans' School Of Hair Design,372489,0,0,372489,0
MO,House Of Heavilin Beauty College,372084,0,0,372084,0
TX,Texas Chiropractic College,77399,103434,191000,371833,0
OH,Firelands Regional Medical Center,71365,109413,191000,371778,0
OH,Rabbinical College Of Telshe,68695,101838,201000,371533,0
PA,Gratz College,54996,111053,205000,371049,0
WV,Roane Jackson Technical Center,73406,108699,188000,370105,0
OK,Chisholm Trail Technology Center School District No. 26,52640,113567,203000,369207,0
NJ,Yeshiva Yesodei Hatorah,73641,107070,188000,368711,0
MO,Paul Mitchell The School St Louis,368274,0,0,368274,0
NY,Elmira Business Institute,367057,0,0,367057,0
TX,Dallas Nursing Institute,366585,0,0,366585,0
CA,South Coast College,366087,0,0,366087,0
PA,Pittsburgh Career Institute,364095,0,0,364095,0
NY,Capri Cosmetology Learning Center,363273,0,0,363273,0
OH,Empire Beauty School,363192,0,0,363192,0
TN,Paul Mitchell The School Murfreesboro,363105,0,0,363105,0
IL,John Amico School Of Hair Design,362538,0,0,362538,0
OH,Brown Aveda Institute,362519,0,0,362519,0
PA,Upmc Jameson School Of Nursing,71186,106156,185000,362342,0
CT,E C Goodwin Technical High School,72504,101723,188000,362227,0
MA,Toni & Guy Hairdressing Academy,362087,0,0,362087,0
PA,Jean Madeline Aveda Institute,361534,0,0,361534,0
OH,Raphael'S School Of Beauty Culture,360731,0,0,360731,0
PR,Caribbean Aviation Training Institute,360410,0,0,360410,0
PA,Laurel Business Institute,360370,0,0,360370,0
MO,Concordia Seminary,61962,104619,193000,359581,160249000
TN,Paul Mitchell The School Knoxville,358657,0,0,358657,0
IN,Concordia Theological Seminary,65681,102693,190000,358374,0
IL,"Calc, Institute Of Technology",356366,0,0,356366,0
TX,Trend Barber College,356178,0,0,356178,0
OH,Eti Technical College Of Niles,355710,0,0,355710,0
CA,Paul Mitchell The School East Bay,355653,0,0,355653,0
PR,Colegio Mayor De Tecnologia,355224,0,0,355224,0
NY,Torah Temimah Talmudical Seminary,66694,104416,184000,355110,0
FL,Ave Maria School Of Law,74489,98550,182000,355039,0
CA,Paul Mitchell The School - Pasadena,354896,0,0,354896,0
PA,Precision Manufacturing Institute,69348,104138,181000,354486,0
NY,New York Conservatory For Dramatic Arts (The),354280,0,0,354280,0
NY,Bais Binyomin Academy,66331,104904,183000,354235,0
TX,Alamo City Barber College,354063,0,0,354063,0
TN,Paul Mitchell The School Memphis,353187,0,0,353187,0
IL,Tricoci University Of Beauty Culture,352709,0,0,352709,0
TX,Mystros Barber Academy,58383,89101,205000,352484,0
FL,Palm Beach Academy Of Health & Beauty,352289,0,0,352289,0
VA,Cayce/Reilly School Of Massage,61587,105979,184000,351566,0
PR,Centro De Estudios Avanzados De Puerto Rico Y El Caribe,36954,110226,204000,351180,0
MO,Pinnacle Career Institute,349930,0,0,349930,0
TN,Middle Tennessee School Of Anesthesia,56794,102676,190000,349470,0
FL,Beauty Academy Of South Florida,348763,0,0,348763,0
WI,Holy Family College,348751,0,0,348751,0
MI,Michigan College Of Beauty-Troy,348449,0,0,348449,0
GA,"Rivertown School Of Beauty, Barber, Skin Care And Nails",348039,0,0,348039,0
FL,Celebrity School Of Beauty,347719,0,0,347719,0
IL,G Skin & Beauty Institute,347284,0,0,347284,0
MI,Calvin Theological Seminary,71301,96593,179000,346894,0
NE,Xenon International Academy Ii,346579,0,0,346579,0
MD,Hair Academy Ii,345610,0,0,345610,0
NY,Shor Yoshuv Rabbinical College,59797,101440,184000,345237,0
KY,Clear Creek Baptist Bible College,41384,110307,192000,343691,0
VA,Fairfax University Of America,78295,93380,172000,343675,0
WI,Institute Of Beauty And Wellness (The),343456,0,0,343456,0
NJ,Rabbi Jacob Joseph School,72804,98114,172000,342918,0
NY,Institute Of Culinary Education,341532,0,0,341532,0
AZ,International Baptist College And Seminary,70347,98089,172000,340436,0
NM,Pima Medical Institute,340233,0,0,340233,0
MA,Boston Baptist College,61817,101261,177000,340078,0
PA,United Lutheran Seminary,56158,99382,184000,339540,0
AZ,Southwest Institute Of Healing Arts,339100,0,0,339100,0
CO,Paul Mitchell The School Colorado Springs,338720,0,0,338720,0
CA,California Institute Of Arts & Technology,338044,0,0,338044,0
CA,Baldy View Regional Occupational Program,61625,99194,177000,337819,0
FL,Taylor College,337759,0,0,337759,0
GA,Atlanta Institute Of Music And Media,337362,0,0,337362,0
OH,Cleveland Barber College,337078,0,0,337078,0
IN,Kenny'S Academy Of Barbering,335777,0,0,335777,0
TX,Advanced Barber College & Hair Design,335473,0,0,335473,0
NY,Cayuga Onondaga Boces,59419,100658,175000,335077,0
GA,Gwinnett College,334880,0,0,334880,0
PA,Bella Capelli Academy A Paul Mitchell Partner School,334723,0,0,334723,0
AL,Midfield Institute Of Cosmetology,38911,93012,202000,333923,0
MO,Bryan University,333687,0,0,333687,0
LA,Moore Career College,332337,0,0,332337,0
NJ,Medical Career Institute,332030,0,0,332030,0
IL,American Academy Of Art,331941,0,0,331941,0
NY,"Christine Valmy International School Foresthetics, Skin Care & Make-Up",331195,0,0,331195,0
CA,Healthcare Career College,331157,0,0,331157,0
TX,School Of Automotive Machinists & Technology,330911,0,0,330911,0
GA,Reformed University,70509,93560,166000,330069,0
CA,California Healing Arts College,329263,0,0,329263,0
WV,Valley College,328669,0,0,328669,71832000
NY,Mesivtha Tifereth Jerusalem Of America,66112,95479,167000,328591,0
CA,Santa Barbara And Ventura Colleges Of Law (The),54315,101170,173000,328485,0
NC,Leon'S Beauty School,328351,0,0,328351,0
TN,Genesis Career College,328276,0,0,328276,0
TN,Richmont Graduate University,62656,92894,172000,327550,0
NJ,Morris County School Of Technology,68148,94184,165000,327332,0
MD,Award Beauty School,327046,0,0,327046,0
MD,Women'S Institute Of Torah Seminary,61745,96119,169000,326864,0
CA,Claremont School Of Theology,66104,91565,169000,326669,0
CA,Central California School Of Continuing Education,326010,0,0,326010,0
NJ,Yeshiva Bais Aharon,64039,95577,166000,325616,0
CT,Cortiva Institute,325544,0,0,325544,0
LA,Aveda Arts & Sciences Institute Baton Rouge,325463,0,0,325463,0
OR,Mount Angel Seminary,71691,90729,163000,325420,0
FL,American College For Medical Careers,323870,0,0,323870,0
IL,Tricoci University Of Beauty Culture,323319,0,0,323319,0
TX,Tri-State Cosmetology Institute,322549,0,0,322549,0
WV,United Technical Center,57801,87433,177000,322234,0
FL,Flagler Technical Institute,33483,101733,187000,322216,0
CA,Sierra College Of Beauty,321871,0,0,321871,0
KS,Z Hair Academy,321716,0,0,321716,0
NJ,Yeshiva Gedolah Of Cliffwood,64764,92377,164000,321141,0
NC,Winston - Salem Barber School,320870,0,0,320870,0
NY,Brittany Beauty School -,320102,0,0,320102,0
CA,Angeles Institute,319593,0,0,319593,0
NJ,Healthcare Training Institute,319461,0,0,319461,0
NY,Center For Allied Health Education,318982,0,0,318982,0
KS,Paul Mitchell The School Overland Park,318952,0,0,318952,0
MO,Grabber School Of Hair Design,318144,0,0,318144,0
IL,Paul Mitchell The School Bradley,317512,0,0,317512,0
WA,Northwest Hvac/R Association & Training,62732,92612,161000,316344,0
MN,Adler Graduate School,53819,92142,170000,315961,0
TX,Toni&Guy Hairdressing Academy I Tigi Creative School,313195,0,0,313195,0
OH,Ohio State College Of Barber Styling,312642,0,0,312642,0
NY,Mesivta Of Eastern Parkway Rabbinical Seminary,60547,91870,160000,312417,0
NY,Neighborhood Playhouse School Of The Theatre (The),60982,86156,165000,312138,0
NY,Brittany Beauty Academy,312065,0,0,312065,0
CA,Advanced Career Institute,311065,0,0,311065,0
CA,Bellus Academy,310881,0,0,310881,0
IL,Larry'S Barber College,310874,0,0,310874,0
CA,California Nurses Educational Institute,309864,0,0,309864,0
OH,Medina County Joint Vocational School,38825,99016,172000,309841,0
NY,Rabbinical College Of Yeshiva And Kolel Bais Medrosh Elyon Association,60982,89412,159000,309394,0
TX,Grace School Of Theology,32732,98060,177000,307792,0
WA,Northwest School Of Wooden Boat Building,63564,79027,165000,307591,0
NY,Oswego County Boces,125152,182318,0,307470,0
FL,South Dade Technical College-South Dade Skills Center Campus,83362,223849,0,307211,0
SC,Southeastern Institute,306951,0,0,306951,0
AZ,Paul Mitchell The School Phoenix,306817,0,0,306817,0
PR,Cambridge Technical Institute,306689,0,0,306689,0
OH,Aveda Fredric'S Institute,306542,0,0,306542,0
MI,Paul Mitchell The School Great Lakes,306375,0,0,306375,0
CO,Paul Mitchell The School Denver,306368,0,0,306368,0
OK,Eve'S College Of Hairstyling,305703,0,0,305703,0
NJ,Robert Fiance Beauty Schools,304898,0,0,304898,0
PR,Leston College,304702,0,0,304702,0
GA,Columbia Theological Seminary,68698,82724,153000,304422,224956000
PR,Neo-Esthetique European Institute,304166,0,0,304166,0
ME,Northeast Technical Institute,303535,0,0,303535,0
IL,Tricoci University Of Beauty Culture,303260,0,0,303260,0
OH,Rosedale Bible College,54367,90756,158000,303123,0
MA,Shawsheen Valley School Of Practical Nursing,56964,83811,162000,302775,0
KY,Paul Mitchell The School Lexington,302711,0,0,302711,0
TX,Central Texas Beauty College 2,302581,0,0,302581,0
OK,Paul Mitchell The School Tulsa,302285,0,0,302285,0
MA,Tri County Regional Vocational Technical High School,61619,87360,153000,301979,0
FL,Daytona College,301333,0,0,301333,0
NV,Paul Mitchell The School Reno,300897,0,0,300897,0
ME,Capilo School Of Hair Design,300391,0,0,300391,0
CA,Modern Technology School,300190,0,0,300190,0
MA,Blackstone Valley Vocational Regional School District,43819,93302,162000,299121,0
GA,Atlanta School Of Massage,298408,0,0,298408,0
IN,Pj'S College Of Cosmetology,297401,0,0,297401,0
MO,Saline County Career Center,52890,78106,166000,296996,0
PR,Inter American University Of Puerto Rico - School Of Optometry,66924,80734,149000,296658,0
MO,Four Rivers Career Center,57399,87143,152000,296542,0
FL,Tenaj Salon Institute,296389,0,0,296389,0
VA,Appalachian College Of Pharmacy,61104,82299,152000,295403,0
IL,Garrett - Evangelical Theological Seminary,54902,84124,156000,295026,0
LA,Compass Career College,294870,0,0,294870,0
CA,California Aeronautical University,294711,0,0,294711,0
IL,G Skin & Beauty Institute,294614,0,0,294614,0
MI,Twin City Beauty College,294015,0,0,294015,0
ME,University Of Maine - Machias,293556,0,0,293556,0
WA,Paul Mitchell The School Spokane,293175,0,0,293175,0
PR,Ponce Health Sciences University,292489,0,0,292489,0
NY,Union Theological Seminary,59416,81565,151000,291981,112560000
CA,San Francisco Institute Of Esthetics & Cosmetology,291524,0,0,291524,0
MA,Elizabeth Grady School Of Esthetics And Massage Therapy,291436,0,0,291436,0
IN,Ravenscroft Beauty College,291246,0,0,291246,0
NM,Toni&Guy Hairdressing Academy,290981,0,0,290981,0
OH,Mahoning County Career And Technical Center,37149,86271,166000,289420,0
RI,Toni & Guy Hairdressing Academy,289022,0,0,289022,0
IL,John Marshall Law School (The),288952,0,0,288952,0
CA,Avalon School Of Cosmetology,288531,0,0,288531,0
SD,North American Baptist Seminary,37001,88162,163000,288163,0
WI,Milwaukee Career College,288092,0,0,288092,0
CA,Salon Professional Academy (The),287982,0,0,287982,0
FL,"Florida Institute Of Recording, Sound And Technology",287242,0,0,287242,0
WA,Seattle School Of Theology And Psychology (The),58777,80079,148000,286856,0
IN,Aveda Fredric'S Institute,286480,0,0,286480,0
CA,Dongguk University Los Angeles,60458,80008,146000,286466,0
MS,Corinth Academy Of Cosmetology,286443,0,0,286443,0
MN,Takoda Institute Of Higher Education,42315,87371,156000,285686,0
PA,Beauty Institute (The),285213,0,0,285213,0
MI,Irene'S Myomassology Institute,284945,0,0,284945,0
FL,Yeshiva Gedolah Rabbinical College,55254,83524,146000,284778,0
VA,Eastern Virginia Career College,284478,0,0,284478,0
IA,Divine Word College,52060,84341,148000,284401,0
NC,Aveda Institute Chapel Hill,284390,0,0,284390,0
FL,Florida School Of Traditional Midwifery,35271,90982,158000,284253,0
OH,Paul Mitchell The School Cleveland,284158,0,0,284158,0
PA,Mercer County Career Center,39531,82328,162000,283859,0
NJ,Yeshivas Emek Hatorah,56454,82397,145000,283851,0
CA,Pacific College,283666,0,0,283666,0
FL,Acupuncture And Massage College,283101,0,0,283101,0
IL,University Of Spa & Cosmetology Arts,281764,0,0,281764,0
AL,Paul Mitchell The School Huntsville,280920,0,0,280920,0
VA,Wave Leadership College,47516,84520,148000,280036,0
CA,Los Angeles College Of Music,279751,0,0,279751,0
PA,Crawford County Career & Technical Center,49853,67542,162000,279395,0
IL,Illinois Eastern Community Colleges -Frontier Community College,279328,0,0,279328,0
NY,New York Theological Seminary,45974,81879,151000,278853,0
MA,C H Mccann Technical School,54800,81488,142000,278288,0
MI,P&A Scholars Beauty School,278254,0,0,278254,0
OH,Paul Mitchell The School Columbus,278089,0,0,278089,0
CA,Fremont College,277847,0,0,277847,0
LA,Aveda Arts & Sciences Institute Lafayette,277500,0,0,277500,0
TN,John A Gupton College,36947,87146,153000,277093,0
CA,Lancaster Beauty School,276907,0,0,276907,0
NJ,Innovate Salon Academy,276460,0,0,276460,0
CT,"North Haven Academy, Llc",276333,0,0,276333,0
NJ,American Institute Of Medical Sciences & Education,276285,0,0,276285,0
DE,Margaret H. Rollins School Of Nursing At Beebe Medical Center,49412,82625,144000,276037,0
LA,My-Le'S Beauty College,275942,0,0,275942,0
TX,Sebring Career Schools,275383,0,0,275383,0
OH,Modern College Of Design (The),274561,0,0,274561,0
MA,Catherine Hinds Institute Of Esthetics,274119,0,0,274119,0
PR,Liberty Junior College,274020,0,0,274020,0
CT,Ace Cosmetology & Barbering Training Center,273453,0,0,273453,0
FL,American Medical Academy,273262,0,0,273262,0
TX,Messenger College,41759,84135,146000,271894,0
AL,Xcell Academy A Paul Mitchell School,271411,0,0,271411,0
UT,Medspa Academies,270463,0,0,270463,0
NY,Otsego Delaware Schoharie Greene Boces,54054,78807,137000,269861,0
MO,Elaine Steven Beauty College,269098,0,0,269098,0
OH,Ohio Technical Center At Vantage Career Center,20672,89410,159000,269082,0
OH,Pontifical College Josephinum,63175,73352,132000,268527,0
GA,Gwinnett College-Sandy Springs,268254,0,0,268254,0
RI,Iyrs School Of Technology & Trades,54919,66281,147000,268200,0
TX,Wade College,268048,0,0,268048,0
TX,Tint School Of Makeup & Cosmetology,267928,0,0,267928,0
NJ,Rizzieri Aveda School For Beauty And Wellness,267582,0,0,267582,0
MO,Conception Seminary College,52627,77941,137000,267568,0
DE,Harris School Of Business,267318,0,0,267318,0
CA,My Le'S Beauty College,266867,0,0,266867,0
IN,Mid America College Of Funeral Service,9117,93670,164000,266787,0
OR,Paul Mitchell The School Portland,266631,0,0,266631,0
TX,Nuvani Institute,266603,0,0,266603,0
IL,Catholic Theological Union At Chicago,47654,76643,142000,266297,0
IL,Tricoci University Of Beauty Culture,265804,0,0,265804,0
MD,Montgomery Beauty School,265117,0,0,265117,0
OH,Vanguard - Sentinel Joint Vocational School District,39503,82013,142000,263516,0
CA,Graduate Theological Union,59068,71509,132000,262577,51475000
PA,Jefferson County Dubois Area Vocational Techl School Practical Nursing,49739,77543,135000,262282,0
CO,Rocky Vista University,262167,0,0,262167,0
GA,Interdenominational Theological Center,44417,76484,141000,261901,0
IL,Erikson Institute,41187,77375,143000,261562,46655000
NY,Berk Trade & Business School,261450,0,0,261450,0
CO,Toni&Guy Hairdressing Academy,261110,0,0,261110,0
WA,Tint School Of Makeup & Cosmetology,260547,0,0,260547,0
NY,Electrical And Hvac/R Training Center,259836,0,0,259836,0
CA,Make-Up Designory,258613,0,0,258613,0
KY,Paul Mitchell The School - Louisville,258448,0,0,258448,0
CA,Career Academy Of Beauty,258413,0,0,258413,0
MO,Poplar Bluff Technical Career Center,50853,75842,131000,257695,0
CA,Presbyterian Theological Seminary In America,41486,77487,138000,256973,0
KS,Eric Fisher Academy,256675,0,0,256675,0
NV,International Academy Of Style,256631,0,0,256631,0
CA,Yo San University Of Traditional Chinese Medicine,59068,69405,128000,256473,0
PA,Huntingdon County Career And Technology Center,45583,73381,137000,255964,0
CA,California Technical Academy,255559,0,0,255559,0
IL,Graham Hospital School Of Nursing,39279,78903,137000,255182,0
NJ,Best Care College,255167,0,0,255167,0
CA,East San Gabriel Valley Rop And Technical Center,255012,0,0,255012,0
OH,School Of Diagnostic Imaging-Cleveland Clinic Health System,48618,72952,133000,254570,0
TX,Academy Of Hair Design,253226,0,0,253226,0
IA,Capri College,253210,0,0,253210,0
CA,America Evangelical University,33544,79214,140000,252758,0
PA,Geisinger-Lewistown Hospital School Of Nursing,32817,79881,140000,252698,0
IA,Capri College,252527,0,0,252527,0
TX,South Texas Training Center,252140,0,0,252140,0
MO,Waynesville Career Center,53380,70502,128000,251882,0
TN,Tennessee School Of Beauty,251557,0,0,251557,0
MO,Lex La Ray Technical Center,44826,74849,131000,250675,0
AR,Arkansas Beauty School- Little Rock,250493,0,0,250493,0
AR,Arkansas College Of Barbering & Hair Design,249875,0,0,249875,0
TN,Jenny Lea Academy Of Cosmetology,249743,0,0,249743,0
NE,College Of Hair Design,249536,0,0,249536,0
VA,Sylvain Melloul International Hair Academy,248788,0,0,248788,0
MI,Michigan School Of Psychology,43937,71594,132000,247531,0
AZ,Phoenix Seminary,42117,71977,133000,247094,0
MI,Carnegie Institute,246994,0,0,246994,0
KY,Summit Salon Academy,246137,0,0,246137,0
OH,Ohio Medical Career College,246076,0,0,246076,0
CA,Ata College,246006,0,0,246006,120223000
FL,Cda Technical Institute,245723,0,0,245723,0
WA,Glen Dow Academy Of Hair Design & Salons,245537,0,0,245537,0
PA,Berks Career & Technology Center,35466,76488,133000,244954,0
MO,American Trade School,244354,0,0,244354,0
PA,Missio Theological Seminary,45643,69688,129000,244331,0
TX,Mt Training Center,244174,0,0,244174,0
NY,International Culinary Center,244131,0,0,244131,0
WY,Wyotech,243773,0,0,243773,0
CA,Hilltop Beauty School,243264,0,0,243264,0
OH,Penta County Vocational School,39934,74315,129000,243249,0
CA,Associated Technical College,243114,0,0,243114,0
TX,Bella Cosmetology And Barber College,242664,0,0,242664,0
TX,Laredo Beauty College,241660,0,0,241660,0
CA,Southern California Seminary,39208,73395,129000,241603,0
CA,Brownson Technical School,241003,0,0,241003,0
CT,Holy Apostles College & Seminary,22522,78426,140000,240948,0
NY,Onondaga School Of Therapeutic Massage,240765,0,0,240765,0
AZ,Southwest University Of Visual Arts,239538,0,0,239538,0
CA,Xavier College School Of Nursing,238863,0,0,238863,0
UT,Taylor Andrews Academy-St. George,238549,0,0,238549,0
FL,Latin Beauty Academy,238057,0,0,238057,0
CA,Angeles College,237819,0,0,237819,0
IN,Salon Professional Academy (The),237818,0,0,237818,0
NM,Aveda Institute Of New Mexico (The),237641,0,0,237641,0
CA,California Hair Design Academy,237120,0,0,237120,0
NC,Paul Mitchell The School Raleigh,237073,0,0,237073,0
HI,Paul Mitchell The School Honolulu,237042,0,0,237042,0
CA,Coastline Beauty College,236995,0,0,236995,0
OH,Greene County Career Center,37198,72515,127000,236713,0
PR,"Charlie'S Guard, Detective Bureau, And Academy",236171,0,0,236171,0
AK,Alaska Bible College,42068,70715,123000,235783,0
NY,Manhattan Institute (The),235112,0,0,235112,0
PR,International Technical College,234857,0,0,234857,0
IN,Rudae'S School Of Beauty Culture,234658,0,0,234658,0
OH,Raphael'S School Of Beauty Culture,234526,0,0,234526,0
NC,Charlotte Christian College And Theological Seminary,32851,73494,128000,234345,0
FL,La Belle Beauty Academy,234070,0,0,234070,0
CA,Coachella Valley Beauty College,233574,0,0,233574,0
IN,Saint Meinrad School Of Theology,40897,67572,125000,233469,0
CA,Professional Institute Of Beauty,233396,0,0,233396,0
CO,Nazarene Bible College,5757,82244,145000,233001,0
FL,St. John Vianney College Seminary,38046,70351,124000,232397,0
NJ,Bais Medrash Mayan Hatorah,46377,66870,119000,232247,0
VA,Paul Mitchell The School Roanoke,232095,0,0,232095,0
ME,The Landing School Of Boatbuilding & Design,43850,67707,120000,231557,0
IA,Aveda Institute Des Moines,231383,0,0,231383,0
CT,Academy Di Capelli,230964,0,0,230964,0
UT,Careers Unlimited,230510,0,0,230510,0
WV,Valley College,230104,0,0,230104,71832000
MS,Magnolia College Of Cosmetology,229881,0,0,229881,0
CA,Asian-American International Beauty College,229596,0,0,229596,0
CA,Career Development Institute,228785,0,0,228785,0
NE,Capitol School Of Hairstyling And Esthetics,228346,0,0,228346,0
FL,Pensacola School Of Massage Therapy & Health Careers,228149,0,0,228149,0
WV,Mineral County Vocational Technical Center,40808,68137,119000,227945,0
KS,Crave Beauty Academy,227937,0,0,227937,0
SD,Stewart School,227595,0,0,227595,0
CA,Gnomon,226588,0,0,226588,0
WA,Fosbre Academy Of Hair Design,226584,0,0,226584,0
PA,Yti Career Institute - Altoona,225942,0,0,225942,0
NM,Southwestern College,45392,63334,117000,225726,0
CA,Newberry School Of Beauty,225726,0,0,225726,0
CA,John Wesley International Barber And Beauty College,225673,0,0,225673,0
PA,Pittsburgh Theological Seminary,40736,64694,120000,225430,0
CA,Academy Of Chinese Culture And Health Sciences,49465,61806,114000,225271,0
PA,Institute Of Medical And Business Careers,225111,0,0,225111,0
OK,Jenks Beauty College,224888,0,0,224888,0
IL,University Of Saint Mary Of The Lake,43064,63728,118000,224792,0
FL,North Florida Cosmetology Institute,224742,0,0,224742,0
FL,Shear Excellence Hair Academy,224489,0,0,224489,0
FL,Summit Salon Academy,224446,0,0,224446,0
PR,Richport Technical College,223803,0,0,223803,0
KS,Old Town Barber College,223567,0,0,223567,0
PA,Cortiva Institute,223392,0,0,223392,0
UT,Rocky Mountain University Of Health Professions,223276,0,0,223276,0
WY,Cheeks Beauty Academy,223185,0,0,223185,0
TX,Kd Conservatory College Of Film And Dramatic Arts,223164,0,0,223164,0
IA,Capri College,222923,0,0,222923,0
LA,Avery James School Of Cosmetology,222638,0,0,222638,0
PA,Yeshivath Beth Moshe,44687,64944,113000,222631,0
NM,Glitz School Of Cosmetology,222535,0,0,222535,0
CA,Bay Area Medical Academy,222337,0,0,222337,0
CA,American Beauty College,221903,0,0,221903,0
KY,Medical Career And Technical College,221558,0,0,221558,0
NY,Digital Film Academy,221487,0,0,221487,0
MI,Michigan State University College Of Law,221124,0,0,221124,0
LA,Ayers Career College,220509,0,0,220509,0
IN,Denmark College,219869,0,0,219869,0
VA,Saint Michael College Of Allied Health,219720,0,0,219720,0
NY,Sharp Edgez Barber Institute,219572,0,0,219572,0
MO,Warrensburg Area Career Center,46106,63356,110000,219462,0
TX,Vogue College - San Antonio,219075,0,0,219075,0
OH,Tri County Career Center/Adult Career Center,22236,71019,125000,218255,0
DC,Institute Of World Politics (The),37536,63272,117000,217808,0
FL,Florida Academy,217593,0,0,217593,0
TX,Dallas Barber & Stylist College,217481,0,0,217481,0
TX,Oblate School Of Theology,39831,62182,115000,217013,0
CA,Palomar Institute Of Cosmetology,216046,0,0,216046,0
CA,Annenberg School Of Nursing,37770,65199,113000,215969,0
CA,California Jazz Conservatory,38567,64325,113000,215892,0
MN,Institute Of Production And Recording (The),215678,0,0,215678,0
MA,Saint John'S Seminary,50920,57709,107000,215629,0
MO,Stevens - The Institute Of Business & Arts,214565,0,0,214565,0
NY,Yeshiva Shaar Hatorah,43952,61551,109000,214503,0
CT,International Institute Of Cosmetology,214064,0,0,214064,0
SD,Headlines Academy,213757,0,0,213757,0
WV,Wood County Technical Center,37341,64175,112000,213516,0
CA,Adrians Beauty College Of Turlock,213440,0,0,213440,0
WV,International Beauty School,213159,0,0,213159,0
MA,New England Hair Academy,213149,0,0,213149,0
CT,Oxford Academy Of Hair Design,212940,0,0,212940,0
AR,Arthur'S Beauty College,212858,0,0,212858,0
MS,Institute Of Health And Technology,212413,0,0,212413,0
CA,San Joaquin College Of Law,42482,59275,110000,211757,0
NJ,Atlantic Beauty & Spa Academy,211628,0,0,211628,0
NY,Rabbinical College Beth Shraga,43268,61178,107000,211446,0
CA,California Career Institute,211121,0,0,211121,0
NH,Empire Beauty Schools,211058,0,0,211058,0
PR,Mayagüez Institute Of Technology,210943,0,0,210943,0
IL,Educators Of Beauty College Of Cosmetology,210787,0,0,210787,0
IN,Paul Mitchell The School Indianapolis,210143,0,0,210143,0
IL,Mccormick Theological Seminary,32880,62124,115000,210004,78025000
IL,Soma Institute - The National School Of Clinical Massage Therapy,209436,0,0,209436,0
AZ,Arizona Culinary Institute,209341,0,0,209341,0
TN,Memphis Theological Seminary,36663,60641,112000,209304,0
FL,New Concept Massage & Beauty School,209257,0,0,209257,0
MS,Mississippi Barber Academy,209055,0,0,209055,0
MO,Paul Mitchell The School Missouri Columbia,208917,0,0,208917,0
FL,Gadsden Technical Institute,41133,60783,107000,208916,0
KS,Hays Academy Of Hair Design,208816,0,0,208816,0
TX,Paul Mitchell The School Austin,208605,0,0,208605,0
TX,Baldwin Beauty Schools,208482,0,0,208482,0
CA,Santa Barbara Business College,208381,0,0,208381,0
NY,Paul Mitchell The School Schenectady,207766,0,0,207766,0
MS,Chris' Beauty College,206812,0,0,206812,0
CA,Contra Costa Medical Career College,206180,0,0,206180,0
TN,Meridian Institute Of Surgical Assisting,205301,0,0,205301,0
CA,Pacifica Graduate Institute,204263,0,0,204263,0
UT,Skin Science Institute Of Laser & Esthetics,204214,0,0,204214,0
TN,Queen City College,203636,0,0,203636,0
CO,Colorado Academy Of Veterinary Technology,203310,0,0,203310,0
FL,International Academy,203011,0,0,203011,0
TX,Ocean Corporation (The),203004,0,0,203004,0
UT,Cameo College Of Essential Beauty,202759,0,0,202759,0
NC,Gwinnett College,202040,0,0,202040,0
VA,Appalachian School Of Law,41609,56349,104000,201958,0
UT,Paul Mitchell The School Logan,201857,0,0,201857,0
AR,Washington Barber College,201847,0,0,201847,0
NJ,Branford Hall Career Institute,201705,0,0,201705,0
OR,Pacific Bible College,23644,64530,113000,201174,0
PA,Beauty Institute (The),201004,0,0,201004,0
IL,Paul Mitchell The School Normal,200795,0,0,200795,0
CA,Elite Cosmetology School,200776,0,0,200776,0
PR,Escuela De Peritos Electricistas De Isabela,200249,0,0,200249,0
WI,Paul Mitchell The School Milwaukee,200128,0,0,200128,0
IL,State Career School,199410,0,0,199410,0
CA,Associated Barber College Of San Diego,199340,0,0,199340,0
CA,Westcliff University,199036,0,0,199036,0
NV,Las Vegas College,198868,0,0,198868,0
DE,Schilling - Douglas School Of Hair Design,198790,0,0,198790,0
WI,Advanced Institute Of Hair Design,198701,0,0,198701,0
CA,American Medical Sciences Center,198625,0,0,198625,0
MA,Montachusett Regional Vocational Technical School,32693,60501,105000,198194,0
FL,Florida International Training Institute,197885,0,0,197885,0
FL,Mcdougle Technical Institute,197728,0,0,197728,0
IL,Capri Oak Forest Beauty College,197482,0,0,197482,0
WV,Randolph Technical Center,36561,55493,105000,197054,0
TX,Cci Training Center,196861,0,0,196861,0
KY,Louisville Presbyterian Theological Seminary,45392,53158,98000,196550,0
VA,Central School Of Practical Nursing,31183,45291,120000,196474,0
CO,Iliff School Of Theology,39110,55176,102000,196286,0
NY,Ace Institute Of Technology,196165,0,0,196165,0
VA,Union Presbyterian Seminary,41609,54003,100000,195612,0
TX,Texas Health School,195533,0,0,195533,0
NY,Continental School Of Beauty Culture,195501,0,0,195501,0
TX,Duvall'S School Of Cosmetology,195388,0,0,195388,0
PA,Jolie Health And Beauty Academy,195046,0,0,195046,0
MI,Protege Academy,194895,0,0,194895,0
IN,Tricoci University Of Beauty Culture,194660,0,0,194660,0
LA,Diesel Driving Academy,194253,0,0,194253,0
OH,Four County Career Center,18106,61957,114000,194063,0
WA,"Elite Cosmetology, Barber & Spa Academy",193873,0,0,193873,0
FL,La Belle Beauty School,193530,0,0,193530,0
NY,Long Island Beauty School,192494,0,0,192494,0
KS,Paul Mitchell The School Wichita,191805,0,0,191805,0
CO,Salon Professional Academy (The),191082,0,0,191082,0
OR,East West College Of The Healing Arts,191055,0,0,191055,0
MI,Paul Mitchell The School Farmington Hills,190962,0,0,190962,0
CT,Platt Technical High School,32573,49006,109000,190579,0
FL,Miami Ad School,190523,0,0,190523,0
LA,Healthcare Training Institute,190122,0,0,190122,0
LA,Stage One-The Hair School,189917,0,0,189917,0
CA,Valley College Of Medical Careers,189724,0,0,189724,0
PR,Monteclaro: Escuela De Hoteleria Y Artes Culinarias,36831,55884,97000,189715,0
NJ,Capri Institute Of Hair Design,189299,0,0,189299,0
FL,Academy Of Career Training,189286,0,0,189286,0
WV,Huntington School Of Beauty Culture,189254,0,0,189254,0
CA,Salon Success Academy,189064,0,0,189064,0
NY,Culinary Tech Center,188968,0,0,188968,0
CA,International College Of Cosmetology,188961,0,0,188961,0
LA,Lasalle Tech,188850,0,0,188850,0
TX,Salon Professional Academy (The),188637,0,0,188637,0
IN,Rogers Academy Of Hair Design,188446,0,0,188446,0
MT,Crevier'S School Of Cosmetology,188300,0,0,188300,0
IN,Summit Salon Academy,187777,0,0,187777,0
CA,Platt College - San Diego,187377,0,0,187377,0
CA,Rosemead Beauty School,187022,0,0,187022,0
MD,Maryland Beauty Academy Of Essex,186678,0,0,186678,0
CA,Ukiah Adult School,49598,49975,87000,186573,0
AL,Heritage Christian University,25804,58456,102000,186260,0
CO,Colorado School Of Trades,186092,0,0,186092,0
NY,Yeshiva Ohr Naftoli,38357,53706,94000,186063,0
NY,American Beauty School,186006,0,0,186006,0
WA,Summit Salon Academy,185557,0,0,185557,0
IA,Wartburg Theological Seminary,34289,53189,98000,185478,0
CA,Urban Barber College,185408,0,0,185408,0
TX,Southeast Texas Career Institute,185252,0,0,185252,0
MI,School Of Missionary Aviation Technology,32257,53894,99000,185151,0
DC,National Conservatory Of Dramatic Arts,40522,52603,92000,185125,0
NY,Atelier Esthetique Institute Of Esthetics,184855,0,0,184855,0
TX,Fort Worth Beauty School,184574,0,0,184574,0
MA,Southern Worcester County Regional Voc School District,43105,51330,90000,184435,0
ND,"Josef'S School Of Hair, Skin & Body",184384,0,0,184384,0
NY,Circle In The Square Theatre School,41430,51823,91000,184253,0
ID,Aveda Institute Twin Falls,184189,0,0,184189,0
CA,Healing Hands School Of Holistic Health,183798,0,0,183798,0
IL,Taylor Business Institute,183531,0,0,183531,0
TN,Williamson Christian College,32878,54341,96000,183219,0
NV,Expertise Cosmetology Institute,183021,0,0,183021,0
CA,Westminster Theological Seminary In California,35790,51530,95000,182320,0
UT,Broadview University,182258,0,0,182258,0
NY,New York Academy Of Art (The),39863,50025,92000,181888,0
IN,Union Bible College,34343,53329,94000,181672,0
AZ,Tucson College Of Beauty,180991,0,0,180991,0
FL,St. Vincent De Paul Regional Seminary,40445,49286,91000,180731,0
TX,Cosmetology Academy Of Texarkana,180042,0,0,180042,0
WV,Morgantown Beauty College,179773,0,0,179773,0
OH,Methodist Theological School In Ohio,37536,50007,92000,179543,0
IL,National Latino Education Institute,40882,50379,88000,179261,0
MD,Baltimore Studio Of Hair Design,179166,0,0,179166,0
MA,Lowell Academy Hair Styling Institute,178641,0,0,178641,0
TX,Austin Presbyterian Theological Seminary,34917,50503,93000,178420,127642000
MI,L'Esprit Academy,178333,0,0,178333,0
MI,Cranbrook Academy Of Art,41027,48193,89000,178220,0
NJ,Total Image Beauty Academy,178161,0,0,178161,0
OH,Salon Institute - Toledo Campus,177967,0,0,177967,0
IL,Universal Spa Training Academy,177669,0,0,177669,0
NY,Webb Institute,41119,48367,88000,177486,66556000
TN,Austin'S Beauty College,177047,0,0,177047,0
OH,Casal Aveda Institute,176993,0,0,176993,0
VA,"School Board - City Of Va. Beach, Va. Beach School Of Prctl. Nrsg.",28074,53783,95000,176857,0
FL,Academy Of Cosmetology,176007,0,0,176007,0
OH,Ohio State Beauty Academy,175286,0,0,175286,0
FL,"Salon Professional Academy - Melbourne, The",175281,0,0,175281,0
FL,National Personal Training Institute,175113,0,0,175113,0
LA,Pat Goins Benton Road Beauty School,175113,0,0,175113,0
MD,Aveda Institute Maryland,174174,0,0,174174,0
PA,Greene County Career & Technology Center,29535,52623,92000,174158,0
FL,L3 Commercial Training Solutions Airline Academy,173310,0,0,173310,0
CA,Cambridge Junior College,172968,0,0,172968,0
PA,Lancaster School Of Cosmetology & Therapeutic Bodywork,172624,0,0,172624,0
PA,Lansdale School Of Business,172490,0,0,172490,0
NY,Aveda Institute New York,172354,0,0,172354,0
FL,"Mercy Hospital School Of Practical Nursing, A Program Of Plantation Ge",172183,0,0,172183,0
AR,Salon Professional Academy (The),172010,0,0,172010,0
OK,American Institute Of Medical Technology,171804,0,0,171804,0
SC,Charleston School Of Law,171674,0,0,171674,0
UT,Aveda Institute Provo,171492,0,0,171492,0
CA,Santa Ana Beauty College,171120,0,0,171120,0
NC,College Of Wilmington,170909,0,0,170909,0
PR,American Technical Institute,170856,0,0,170856,0
SD,Black Hills Beauty College,170310,0,0,170310,0
IN,Christian Theological Seminary,31256,48815,90000,170071,0
IN,Caris College,169712,0,0,169712,0
MI,Abcott Institute,169653,0,0,169653,0
PR,Seminario Evangelico De Puerto Rico,29679,48961,91000,169640,0
IA,Iowa School Of Beauty,169529,0,0,169529,0
MA,Rob Roy Academy,168757,0,0,168757,0
CA,National Polytechnic College,168452,0,0,168452,0
NY,Transitions Career Institute School Of Nursing,167929,0,0,167929,0
PA,Roxborough Memorial Hospital,167758,0,0,167758,0
CA,Palace Beauty College,167681,0,0,167681,0
WA,Paroba College Of Cosmetology,167414,0,0,167414,0
AZ,Hds Truck Driving Institute,167052,0,0,167052,0
MA,Hebrew College,32876,47086,87000,166962,0
CA,Alhambra Beauty College,166902,0,0,166902,0
MI,Elevate Salon Institute,166435,0,0,166435,0
CA,Presidio Graduate School,38408,44860,83000,166268,0
CA,California Career College,166258,0,0,166258,0
CA,Lytle'S Redwood Empire Beauty College,166160,0,0,166160,0
CA,Shasta Bible College And Graduate School,26199,50945,89000,166144,0
PA,Trinity Episcopal School For Ministry,27473,48571,90000,166044,0
ID,Austin Kade Academy,165658,0,0,165658,0
IL,Pivot Point Academy,165647,0,0,165647,0
IL,Phipps Academy Of Barbering,165608,0,0,165608,0
DE,Paul Mitchell The School - Delaware,165470,0,0,165470,0
NY,Salon Professional Academy (The),165215,0,0,165215,0
FL,Nri Institute Of Health Sciences,163872,0,0,163872,0
HI,Hawaii Institute Of Hair Design,163841,0,0,163841,0
AZ,Arizona School Of Integrative Studies,163548,0,0,163548,0
IN,Lil Lou'S Beauty And Barber College Llc,163493,0,0,163493,0
AR,Paul Mitchell The School Arkansas,163392,0,0,163392,0
CA,Medical Allied Career Center,163365,0,0,163365,0
TX,Baptist Missionary Association Theological Seminary,20831,51368,91000,163199,0
IL,Ambria College Of Nursing,162885,0,0,162885,0
CA,"International College Of Beauty, Arts & Sciences",162618,0,0,162618,0
TN,Memphis College Of Art,162346,0,0,162346,0
CA,Victory Career College,162289,0,0,162289,0
TX,Texas Beauty College,162091,0,0,162091,0
NJ,Yeshiva Gedolah Zichron Leyma,31665,47403,83000,162068,0
NJ,Universal Training Institute,162039,0,0,162039,0
TX,Houston International College Cardiotech Ultrasound School,161545,0,0,161545,0
MN,Nova Academy Of Cosmetology,160801,0,0,160801,0
AL,New Beginning College Of Cosmetology,160764,0,0,160764,0
NC,Hood Theological Seminary,31336,45372,84000,160708,0
CA,California Institute Of Advanced Management,15039,50997,94000,160036,0
NJ,Saint Francis Medical Center,23963,48506,87000,159469,0
AR,Searcy Beauty College,159333,0,0,159333,0
MO,Cass Career Center,37739,44056,77000,158795,0
CA,Universal Healthcare Careers College,158672,0,0,158672,0
WV,B M Spurr School Of Practical Nursing,31232,46255,81000,158487,0
PA,Ohio Valley General Hospital School Of Nursing,21308,49080,88000,158388,0
LA,Diesel Driving Academy,158043,0,0,158043,0
MO,Kenrick - Glennon Seminary,29970,45065,83000,158035,0
CA,Galaxy Medical College,157375,0,0,157375,0
MO,Eden Theological Seminary,31134,44241,82000,157375,0
MI,Michigan College Of Beauty-Monroe,157293,0,0,157293,0
NY,Carsten Institute Of Cosmetology,157005,0,0,157005,0
CA,California Barber And Beauty College,156711,0,0,156711,0
UT,Barber School (The) By Tim Hite,156033,0,0,156033,0
CA,Diamond Beauty College,155896,0,0,155896,0
AZ,Regional Center For Border Health,13967,49729,92000,155696,0
VA,Tomorrow'S Image Barber & Beauty Academy Of Virginia,155646,0,0,155646,0
MO,Salon Professional Academy (The),155262,0,0,155262,0
UT,American Beauty Academy,155076,0,0,155076,0
CA,Lawrence & Company College Of Cosmetology,154888,0,0,154888,0
OH,Tri-State Bible College,25800,46738,82000,154538,0
NJ,Robert Fiance Beauty Schools,154526,0,0,154526,0
GA,International School Of Skin And Nailcare,154203,0,0,154203,0
MO,City Pointe Beauty Academy,153715,0,0,153715,0
CA,North Adrian'S College Of Beauty,153436,0,0,153436,0
MI,Paul Mitchell The School Grand Rapids,153424,0,0,153424,0
FL,Asm Beauty World Academy,153271,0,0,153271,0
CA,"Acupuncture And Integrative Medicine College, Berkeley",31425,42818,79000,153243,0
MT,Montana Academy Of Salons,152333,0,0,152333,0
IL,Hair Professionals School Of Cosmetology,152298,0,0,152298,0
DC,Dominican House Of Studies,30552,42675,79000,152227,0
WI,Salon Professional Academy (The),152081,0,0,152081,0
VA,American Massage & Bodywork Institute,151958,0,0,151958,0
WV,Charleston School Of Beauty Culture,151472,0,0,151472,0
AR,Arthur'S Beauty College,151409,0,0,151409,0
MT,Bold Beauty Academy,151384,0,0,151384,0
LA,"Guy'S Academy Hair, Skin & Nails",151266,0,0,151266,0
OK,Broken Arrow Beauty College,150425,0,0,150425,0
TX,Vogue College Of Cosmetology,150129,0,0,150129,0
MA,Jolie Hair And Beauty Academy,150088,0,0,150088,0
TX,Diamonds Cosmetology College,149983,0,0,149983,0
TX,Vocational Nursing Institute (The),17734,48103,84000,149837,0
OH,International College Of Broadcasting,149705,0,0,149705,0
CA,Design Institute Of San Diego,149639,0,0,149639,0
FL,Paul Mitchell The School Miami,149326,0,0,149326,0
WI,Salon Professional Academy Of Kenosha (The),149246,0,0,149246,0
NH,Empire Beauty Schools,149165,0,0,149165,0
NY,Island Drafting & Technical Institute,149013,0,0,149013,0
PA,Hazleton Area Career Center,33666,42190,73000,148856,0
TX,Salon & Spa Institute,148644,0,0,148644,0
UT,Renaissance Academie,148303,0,0,148303,0
GA,Toni & Guy Hairdressing Academy,147974,0,0,147974,0
CA,Citrus Heights Beauty College,147682,0,0,147682,0
IL,Northern Baptist Theological Seminary,16994,45653,84000,146647,0
GA,Keune Academy By 124,146504,0,0,146504,0
WA,Victoria'S Academy Of Cosmetology,146462,0,0,146462,0
FL,Suncoast Technical Education Center,17940,46513,82000,146453,0
CA,Pci College,146325,0,0,146325,0
MA,Boston Graduate School Of Psychoanalysis,25606,42390,78000,145996,0
MA,Millennium Training Institute,145817,0,0,145817,0
IL,Salon Professional Academy (The),145367,0,0,145367,0
CA,Lyle'S College Of Beauty,145271,0,0,145271,0
NJ,Artistic Academy Of Hair Design (The),144984,0,0,144984,0
FL,Future-Tech Institute,144916,0,0,144916,0
WI,First Class Cosmetology School,144868,0,0,144868,0
LA,Digital Media Institute At Intertech,19224,45578,80000,144802,0
NY,Modern Welding School,143813,0,0,143813,0
NY,Arrojo Cosmetology School,143683,0,0,143683,0
WA,Bj'S Beauty & Barber College,143520,0,0,143520,0
TN,Edumed Partners,143284,0,0,143284,0
WV,John D. Rockefeller Iv Career Center,15141,46804,81000,142945,0
CO,Salon Professional Academy (The),142706,0,0,142706,0
NY,New York Institute Of Beauty,142667,0,0,142667,0
OH,Great Lakes Truck Driving School,142439,0,0,142439,0
VA,Chrysm Institute Of Esthetics (The),142024,0,0,142024,0
GA,New Horizons Medical Institute,141871,0,0,141871,0
NJ,Paul Mitchell The School - Jersey Shore,141637,0,0,141637,0
TX,Episcopal Theological Seminary Of The Southwest (The),29097,39401,73000,141498,0
CT,Ricci'S Toni & Guy Hairdressing Academy/ Tigi Creative School,141397,0,0,141397,0
MI,Western Theological Seminary,24397,40937,76000,141334,0
WI,Sacred Heart Seminary And School Of Theology,28515,39714,73000,141229,0
FL,Loraines Academy & Spa,141007,0,0,141007,0
PA,Evangelical Theological Seminary,20659,42286,78000,140945,0
MS,Traxler'S School Of Hair,140747,0,0,140747,0
FL,Summit Salon Academy - Gainesville,140570,0,0,140570,0
CA,Pardee Rand Graduate School,29679,38823,72000,140502,0
OH,"North Coast College, The",140180,0,0,140180,0
CO,Rolf Institute Of Structural Integration (The),23419,40573,76000,139992,0
TX,Neecee'S Barber College,139821,0,0,139821,0
NM,Universal Therapeutic Massage Institute,139681,0,0,139681,0
NY,Westchester School For Dental Assistants,139681,0,0,139681,0
TN,Vibe Barber College,139552,0,0,139552,0
FL,San Ignacio University,139442,0,0,139442,0
PA,Premier Barber Institute,139299,0,0,139299,0
CA,Southern States University,139085,0,0,139085,0
IL,Douglas J Aveda Institute-Chicago,138888,0,0,138888,0
WA,Northwest College Of Art & Design,138482,0,0,138482,0
FL,Parisian Spa Institute,138096,0,0,138096,0
OH,Payne Theological Seminary,25666,39396,73000,138062,0
FL,Florida Academy Of Health & Beauty,137965,0,0,137965,0
AR,Designer Barber & Stylist School,137801,0,0,137801,0
VA,Southside College Of Health Sciences,137088,0,0,137088,0
IL,Networks Barber College,136724,0,0,136724,0
TX,Ucas University Of Cosmetology Arts & Sciences,136263,0,0,136263,0
IL,Estelle International,136220,0,0,136220,0
MO,Healing Arts Center,136151,0,0,136151,0
VA,Bethel College,19542,42577,74000,136119,0
TX,Hands On Therapy,135777,0,0,135777,0
FL,Medical Institute Of Palm Beach,135341,0,0,135341,0
VT,Marlboro College,135285,0,0,135285,0
OR,Johnny Matthew'S Hairdressing Training School,135109,0,0,135109,0
LA,John Jay Beauty College,135023,0,0,135023,0
NJ,Garden State Science And Technology Institute,134873,0,0,134873,0
ND,Salon Professional Academy (The),134350,0,0,134350,0
IL,Meadville Theological School Of Lombard College,26188,38060,70000,134248,0
CA,Advance Beauty Techs Academy,134174,0,0,134174,0
CT,Industrial Management & Training Institute,133714,0,0,133714,0
MO,Aquinas Institute Of Theology,19160,39833,74000,132993,0
CA,Fab School (The),132973,0,0,132973,0
CO,Avalon School Of Cosmetology,132880,0,0,132880,0
PA,Pennsylvania Gunsmith School,132479,0,0,132479,0
PA,Metro Beauty Academy,132460,0,0,132460,0
NH,Michael'S School Of Hair Design & Esthetics Paul Mitchell Partner Scho,132378,0,0,132378,0
CA,Zms The Academy,132113,0,0,132113,0
IA,Eq School Of Hair Design,132044,0,0,132044,0
TN,Mid-South Christian College,24705,38967,68000,131672,0
CT,Howell Cheney Technical High School,31645,35706,64000,131351,0
UT,Healing Mountain Massage School,131175,0,0,131175,0
FL,More Tech Institute,130953,0,0,130953,0
CA,Flair Beauty College,130763,0,0,130763,0
CA,Coba Academy,130645,0,0,130645,0
WA,Stylemasters College Of Hair Design,130349,0,0,130349,0
NY,Center For Ultrasound Research & Education,129533,0,0,129533,0
NY,Central Yeshiva Beth Joseph,32027,35423,62000,129450,0
CO,College Of International Esthetics,129153,0,0,129153,0
TX,Houston Graduate School Of Theology,21241,37777,70000,129018,0
IL,Lutheran School Of Theology At Chicago,22405,37553,69000,128958,0
ID,Salon Professional Academy (The),128759,0,0,128759,0
LA,Cosmetology Training Center,128629,0,0,128629,0
PR,Ivaem College,127721,0,0,127721,0
TX,Jay'S Technical Institute,126939,0,0,126939,0
FL,Talmudic College Of Florida,27499,36194,63000,126693,0
NC,Mitchell'S Academy,125900,0,0,125900,0
OR,Summit Salon Academy - Portland,125842,0,0,125842,0
CA,Design'S School Of Cosmetology,125204,0,0,125204,0
TX,G.A. Beauty & Barber School,124879,0,0,124879,0
MO,Skin Institute,124835,0,0,124835,0
ID,Boise Barber College A D.Martin Academy,124720,0,0,124720,0
NJ,New Brunswick Theological Seminary,24151,35388,65000,124539,0
OH,Orion Institute,124387,0,0,124387,0
IL,Trenz Beauty Academy,124177,0,0,124177,0
NY,Yeshiva Gedola Ohr Yisrael,23803,36063,64000,123866,0
IA,Salon Professional Academy (The),123699,0,0,123699,0
NJ,Pb Cosmetology Education Centre,122908,0,0,122908,0
CA,Hoss Lee Academy,122657,0,0,122657,0
CA,Academy For Salon Professionals,122587,0,0,122587,0
GA,Atlanta'S John Marshall Law School,122500,0,0,122500,0
TX,Laredo Chi Academy Beauty School,122419,0,0,122419,0
OR,College Of Cosmetology,122071,0,0,122071,0
FL,American Academy Of Cosmetology,122040,0,0,122040,0
IN,Summit Salon Academy Kokomo,121654,0,0,121654,0
MD,Aspen Beauty Academy - Laurel,121302,0,0,121302,0
SC,Southeastern Esthetics Institute,121278,0,0,121278,0
SC,International Diving Institute,121044,0,0,121044,0
WA,Gary Manuel Aveda Institute,121011,0,0,121011,0
OK,Phillips Theological Seminary,14422,37560,69000,120982,0
CA,American Conservatory Theater Foundation,25315,33386,62000,120701,0
IA,La' James College Of Hairstyling,120456,0,0,120456,0
MS,Academy Of Hair Design #4,120390,0,0,120390,0
CA,Five Branches University,120172,0,0,120172,0
OH,Moler - Pickens Beauty College,119658,0,0,119658,0
IN,Paul Mitchell The School Merrillville,119533,0,0,119533,0
IL,Worsham College Of Mortuary Science,119293,0,0,119293,0
OR,Birthingway College Of Midwifery,18505,36531,64000,119036,0
OH,Spa School (The),118984,0,0,118984,0
CA,Stellar Career College,118426,0,0,118426,0
PA,Jna Institute Of Culinary Arts,118411,0,0,118411,0
NJ,Central Career School,118376,0,0,118376,0
WI,Panache Academy Of Beauty,118221,0,0,118221,0
NJ,Christine Valmy International School Of Esthetics & Cosmetology,118012,0,0,118012,0
MO,Hillyard Technical Center,117910,0,0,117910,0
NY,Shear Ego International School Of Hair Design,117714,0,0,117714,0
OH,Ohio State School Of Cosmetology,117582,0,0,117582,0
FL,Academy For Five Element Acupuncture,21823,33364,62000,117187,0
TX,Ann Webb Skin Institute,117072,0,0,117072,0
LA,Bos-Man'S Barber College,117057,0,0,117057,0
OK,Jb'S Hair Design And Barber College,116861,0,0,116861,0
NE,Summit Christian College,19025,35739,62000,116764,0
IL,Debutantes School Of Cosmetology And Nail Technology,116746,0,0,116746,0
CA,Starr King School For The Ministry,23860,32584,60000,116444,0
PA,Lancaster Theological Seminary Of The United Church Of Christ,19204,34212,63000,116416,0
PA,Butler Beauty Academy,116401,0,0,116401,0
OH,Elite Welding Academy,115917,0,0,115917,0
NJ,Institute For Therapeutic Massage,115588,0,0,115588,0
IL,"Mr. John'S School Of Cosmetology, Esthetics & Nails",115442,0,0,115442,0
PA,Salon Professional Academy (The),114999,0,0,114999,0
CA,Beyond 21St Century Beauty Academy,114734,0,0,114734,0
NY,Yeshiva Of Far Rockaway Derech Ayson Rabbinical Seminary,23752,32799,58000,114551,0
TN,Salon Professional Academy (The),114277,0,0,114277,0
CO,Rocky Mountain Montessori Teacher Training Program,20588,33682,60000,114270,0
KY,American College Of Barbering,114269,0,0,114269,0
MS,Goshen School Of Cosmetology,114257,0,0,114257,0
IL,Bell Mar Beauty College,113974,0,0,113974,0
MD,Blades School Of Hair Design,113715,0,0,113715,0
NY,Saint Vladimirs Orthodox Theological Seminary,24442,31141,58000,113583,0
IA,Unitypoint Health-Des Moines,21716,28762,63000,113478,0
NY,Center For Natural Wellness School Of Massage Therapy,113394,0,0,113394,0
IL,Northshore University Healthsystem School Of Nurse Anesthesia,23860,31511,58000,113371,0
TX,Barber Institute Of Texas,113248,0,0,113248,0
GA,Creative Circus (The),113193,0,0,113193,0
OR,College Of Hair Design Careers,112927,0,0,112927,0
CA,Shasta School Of Cosmetology,112740,0,0,112740,0
IL,Hairmasters Institute Of Cosmetology,112704,0,0,112704,0
IL,Chicago Theological Seminary,17058,33605,62000,112663,0
NY,Westchester School Of Beauty Culture,112451,0,0,112451,0
MO,Central College Of Cosmetology,112354,0,0,112354,0
TN,"Watkins College Of Art, Design & Film",112124,0,0,112124,0
MA,Digrigoli School Of Cosmetology,111760,0,0,111760,0
MI,Detroit Business Institute - Downriver,111552,0,0,111552,0
IL,Cameo Beauty Academy,111227,0,0,111227,0
PA,Won Institute Of Graduate Studies,18913,32274,60000,111187,0
PA,Levittown Beauty Academy,111172,0,0,111172,0
MO,Lake Career & Technical Center,18569,29492,63000,111061,0
CA,California Miramar University,110771,0,0,110771,0
CA,Pacific School Of Religion,24442,30153,56000,110595,0
NJ,Capri Institute Of Hair Design,110520,0,0,110520,0
CA,Cr'U Institute Of Cosmetology And Barbering,110487,0,0,110487,0
VA,Bon Secours St Mary'S Hospital School Of Medical Imaging,22589,31687,56000,110276,0
PA,Cde Career Institute,110238,0,0,110238,0
FL,Cozmo Beauty School,110109,0,0,110109,0
OH,Paramount Beauty Academy,109818,0,0,109818,0
CT,Hartford Seminary,17007,32702,60000,109709,47901000
TX,Charles & Sue'S School Of Hair Design,109527,0,0,109527,0
NY,Grace International Beauty School,109223,0,0,109223,0
OH,Northern Institute Of Cosmetology,108952,0,0,108952,0
SC,Charzanne Beauty College,108888,0,0,108888,0
MD,Del-Mar-Va Beauty Academy,108845,0,0,108845,0
MN,Model College Of Hair Design,108435,0,0,108435,0
TN,Sandra Academy Of Salon Services,108427,0,0,108427,0
WA,Studio Beauty School,108031,0,0,108031,0
AZ,Arizona Academy Of Beauty,107836,0,0,107836,0
KY,Pj'S College Of Cosmetology,107097,0,0,107097,0
IA,Iowa School Of Beauty,106994,0,0,106994,0
NY,Long Island Nail Skin & Hair Institute,106834,0,0,106834,0
TX,Ucas University Of Cosmetology Arts & Sciences,106620,0,0,106620,0
MD,Yeshiva College Of The Nation'S Capital,19734,31640,55000,106374,0
OH,National Beauty College,106210,0,0,106210,0
VT,O'Briens Aveda Institute,106040,0,0,106040,0
CA,Lawrence & Company College Of Cosmetology,106027,0,0,106027,0
CA,Cosmo Beauty Academy,105841,0,0,105841,0
RI,Michael K. Galvin Beauty & Business Academy,105677,0,0,105677,0
NC,Jung Tao School Of Classical Chinese Medicine,23569,28834,53000,105403,0
OR,Phagans' Central Oregon Beauty College,105390,0,0,105390,0
NJ,Joe Kubert School Of Cartoon & Graphic Art (The),105343,0,0,105343,0
AL,Blue Cliff Career College,105082,0,0,105082,0
OH,Gerber Akron Beauty School,104975,0,0,104975,0
OH,Elite School Of Cosmetology,104805,0,0,104805,0
IN,J. Michael Harrold Beauty Academy,104382,0,0,104382,0
FL,American Advanced Technicians Institute,104373,0,0,104373,0
MI,Flint Institute Of Barbering,104198,0,0,104198,0
TX,Nuvani Institute,104127,0,0,104127,0
CA,Independent Training & Apprenticeship Program,104035,0,0,104035,0
CA,Princess Institute Of Beauty,103999,0,0,103999,0
NC,Pinnacle Institute Of Cosmetology,103889,0,0,103889,0
LA,Louisiana Culinary Institute,103694,0,0,103694,0
MS,Kc'S School Of Hair Design,103552,0,0,103552,0
WA,Evergreen Beauty And Barber College,103456,0,0,103456,0
CA,Hinton Barber And Beauty College,103446,0,0,103446,0
NY,Academy Of Cosmetology & Esthetics Nyc (The),102983,0,0,102983,0
NY,Champlain Valley Physicians Hospital Medical Center,20970,29862,52000,102832,0
OH,Allstate Hairstyling & Barber College,102790,0,0,102790,0
MO,Missouri College Of Cosmetology North,102704,0,0,102704,0
MS,Academy Of Hair Design #6,102117,0,0,102117,0
TX,Natural Images Beauty College,102034,0,0,102034,0
WA,Seattle Film Institute,101834,0,0,101834,0
LA,Cloyd'S Beauty School #3,101047,0,0,101047,0
TN,Pentecostal Theological Seminary,14436,30528,56000,100964,0
LA,Infinity College,100915,0,0,100915,0
LA,J'S Barber College,100902,0,0,100902,0
OH,Summit Salon Academy,100760,0,0,100760,0
CA,Interior Designers Institute,100622,0,0,100622,0
NY,Unification Theological Seminary,20435,28113,52000,100548,0
CA,Palladium Technical Academy,100425,0,0,100425,0
OH,Dayton Barber College,100249,0,0,100249,0
NY,Northeastern Seminary,15122,29988,55000,100110,0
OH,Davis College,99923,0,0,99923,0
CA,Estes Institute Of Cosmetology Arts & Sciences,99744,0,0,99744,0
WV,Clarksburg Beauty Academy & School Of Massage Therapy,99727,0,0,99727,0
AR,New Tyler Barber College,99723,0,0,99723,0
CO,United Beauty College,99695,0,0,99695,0
PA,Barber School Of Pittsburgh,99473,0,0,99473,0
MN,United Theological Seminary Of The Twin Cities,17458,28920,53000,99378,0
OK,Shawnee Beauty College,99268,0,0,99268,0
TX,Salon Boutique Academy,98873,0,0,98873,0
ID,Aveda Institute Boise,98861,0,0,98861,0
FL,Aviator College Of Aeronautical Science & Technology,98828,0,0,98828,0
CA,California College Of Barbering And Cosmetology,98672,0,0,98672,0
TN,Nashville Film Institute,98653,0,0,98653,0
CA,My Beauty & Barber College,98476,0,0,98476,0
MA,Alexander Academy,98351,0,0,98351,0
LA,Stevenson Academy Of Hair Design,98324,0,0,98324,0
OR,Beau Monde Academy Of Cosmetology,98322,0,0,98322,0
VT,New England Culinary Institute,98063,0,0,98063,0
ID,Cosmetology School Of Arts And Sciences,97960,0,0,97960,0
NJ,Divers Academy Of The Eastern Seaboard,97783,0,0,97783,0
WV,West Virginia University Hospitals,20244,27492,50000,97736,0
KS,Saint Paul School Of Theology,20672,27032,50000,97704,0
CO,Elevate Salon Institute,97669,0,0,97669,0
LA,Celebrity Stylist Beauty School,97628,0,0,97628,0
TX,Manuel & Theresa'S School Of Hair Design,97462,0,0,97462,0
FL,Sarasota School Of Massage Therapy,97165,0,0,97165,0
LA,Denham Springs Beauty College,97153,0,0,97153,0
MO,Summit Salon Academy Kansas City,97014,0,0,97014,0
CA,"Thanh Le College, School Of Cosmetology",96857,0,0,96857,0
MS,Mississippi College Of Beauty Culture,96624,0,0,96624,0
FL,Florida Coastal School Of Law,96603,0,0,96603,0
LA,D'Jay'S Institute Of Cosmetology And Esthiology,96315,0,0,96315,0
KS,Mitsu Sato Hair Academy,96274,0,0,96274,0
CA,San Bernardino Beauty College,96223,0,0,96223,0
TN,Elite College Of Cosmetology,96164,0,0,96164,0
NJ,Capri Institute Of Hair Design,96142,0,0,96142,0
MS,"Mississippi Institute Of Aesthetics, Nails, & Cosmetology",96122,0,0,96122,0
FL,Florida School Of Massage,96011,0,0,96011,0
IL,Institute For Clinical Social Work,15713,28239,52000,95952,0
OH,Hamrick School,95932,0,0,95932,0
UT,Collectiv Hair Dressing Academy,95923,0,0,95923,0
NY,"Joffrey Ballet School, American Ballet Center",95735,0,0,95735,0
IN,Horizon University,7486,31710,56000,95196,0
FL,Trendsetters Of Fl. School Of Beauty & Barbering,95086,0,0,95086,0
VA,Iglobal University,95038,0,0,95038,0
IL,Educators Of Beauty College Of Cosmetology,94989,0,0,94989,0
NJ,Capri Institute Of Hair Design,94976,0,0,94976,0
IL,Spertus College Of Judaica,11595,29093,54000,94688,0
IL,Hair Professionals Career College,94467,0,0,94467,0
KY,Appalachian Beauty School,94425,0,0,94425,0
CA,California Christian College,12359,30024,52000,94383,0
LA,Park Place Premier Barber School,94356,0,0,94356,0
CA,University Of East-West Medicine,94275,0,0,94275,0
AZ,Turning Point Beauty College,94238,0,0,94238,0
WI,Paul Mitchell The School - Madison,94232,0,0,94232,0
UT,Myotherapy College Of Utah,94214,0,0,94214,0
IL,Cannella School Of Hair Design,93948,0,0,93948,0
WV,Meredith Manor International Equestrian Centre,93719,0,0,93719,0
FL,Piberry Institute,93447,0,0,93447,0
NY,New York Institute Of Massage,93376,0,0,93376,0
OH,Cincinnati School Of Barbering & Hair Design,93183,0,0,93183,0
PA,Studio Incamminati,14667,28403,50000,93070,0
UT,Acaydia Spa And School Of Aesthetics,92748,0,0,92748,0
NH,Harmony Health Care Institute,91855,0,0,91855,0
NE,Paul Mitchell The School - Lincoln,91829,0,0,91829,0
MO,Research Medical Center,91737,0,0,91737,0
AZ,International Barber College,91467,0,0,91467,0
WI,Nashotah House,16876,26136,48000,91012,0
IL,Hvac Technical Institute,90904,0,0,90904,0
NE,Chi Health School Of Radiologic Technology,20297,23431,47000,90728,0
NY,Talmudical Institute Of Upstate New York,17933,26497,46000,90430,0
OK,Academy Of Hair Design (The),90375,0,0,90375,0
MO,Merrell University Of Beauty Arts & Science,90177,0,0,90177,0
AL,Salon Professional Academy (The),90139,0,0,90139,0
NC,Shepherds Theological Seminary,16125,25893,48000,90018,0
PA,Venus Beauty Academy,89682,0,0,89682,0
NY,"John Paolo'S Xtreme Beauty Institute, Goldwell Products Artistry",89593,0,0,89593,0
CA,American Institute Of Massage Therapy,89422,0,0,89422,0
CA,J D Academy Of Salon And Spa,89296,0,0,89296,0
NY,Midway Paris Beauty School,89208,0,0,89208,0
ID,Mr. Leon'S School Of Hair Design,89201,0,0,89201,0
LA,Pineville Beauty School,89065,0,0,89065,0
NY,Long Island Beauty School,88800,0,0,88800,0
CA,Integrity College Of Health,88763,0,0,88763,0
ID,Elevate Salon Institute,88720,0,0,88720,0
GA,Hogan Institute Of Cosmetology And Esthetics,88626,0,0,88626,0
FL,Hope College Of Arts And Sciences,88555,0,0,88555,0
AL,Cardiac And Vascular Institute Of Ultrasound,88302,0,0,88302,0
AR,Delta Designs Cosmetology School,88170,0,0,88170,0
CA,Church Divinity School Of The Pacific,18783,24290,45000,88073,16243000
SC,Strand College Of Hair Design,87957,0,0,87957,0
TX,South Texas Barber College,87713,0,0,87713,0
PA,South Hills Beauty Academy,87671,0,0,87671,0
MN,Centerpoint Massage & Shiatsu Therapy School & Clinic,87374,0,0,87374,0
FL,Interamerican Technical Institute,87212,0,0,87212,0
OH,Inner State Beauty School,87203,0,0,87203,0
CA,Regan Career Institute,87162,0,0,87162,0
MO,Eclips School Of Cosmetology And Barbering,87102,0,0,87102,0
NC,Alexander Paul Institute Of Hair Design,86901,0,0,86901,0
OR,Phagans' Grants Pass College Of Beauty,86854,0,0,86854,0
MA,Pope St. John Xxiii National Seminary,21532,22984,42000,86516,0
IL,Cannella School Of Hair Design,86227,0,0,86227,0
WV,Mountain State College,86177,0,0,86177,0
NJ,Cutting Edge Academy,85930,0,0,85930,0
FL,Salon Professional Academy (The),85687,0,0,85687,0
NY,Washington Saratoga Warren Hamilton Essex Boces,22752,20845,42000,85597,0
MN,Academy College,85565,0,0,85565,0
SC,Academy Of Hair Technology,85165,0,0,85165,0
TN,Image Maker Beauty Institute,85137,0,0,85137,0
TX,Exposito School Of Hair Design,84964,0,0,84964,0
MO,Salem College Of Hairstyling,84962,0,0,84962,0
PA,Dci Career Institute,84945,0,0,84945,0
MO,Academy Of Salon Professionals,84787,0,0,84787,0
ME,Seacoast Career Schools,84741,0,0,84741,0
CT,Dolce Llc The Academy,84286,0,0,84286,0
CA,Professional Golfers Career College,84229,0,0,84229,0
FL,First Coast Barber Academy,83945,0,0,83945,0
TX,Austin Graduate School Of Theology,10135,26735,47000,83870,0
IL,Rosel School Of Cosmetology,83474,0,0,83474,0
ME,Institute For Doctoral Studies In The Visual Arts,14258,24140,45000,83398,0
CA,Ati College,83260,0,0,83260,0
OR,Phagans' Beauty College,83228,0,0,83228,0
LA,Louisiana Academy Of Beauty,83167,0,0,83167,0
UT,Evans Hairstyling College Of Cedar City,83133,0,0,83133,0
AL,Winonah'S International School Of Cosmetology,82925,0,0,82925,0
SC,Barber Tech Academy,82720,0,0,82720,0
CA,Fredrick And Charles Beauty College,82451,0,0,82451,0
CA,Colleen O'Hara'S Beauty Academy,82427,0,0,82427,0
GA,Dalton Institute Of Esthetics And Cosmetology,82217,0,0,82217,0
PA,Beaver Falls Beauty Academy,82135,0,0,82135,0
AZ,All Beauty College,82062,0,0,82062,0
CA,Emperor'S College Of Traditional Oriental Medicine,82054,0,0,82054,0
VA,Divine Mercy University,12649,24391,45000,82040,0
AR,Academy Of Salon And Spa,81774,0,0,81774,0
TX,University Of Texas Health Science Center At Tyler (The),9311,25459,47000,81770,0
NY,"Aesthetic Science Institute, Llc (The)",81723,0,0,81723,0
AR,Hot Springs Beauty College,81480,0,0,81480,0
TX,Astrodome Career Centers,81224,0,0,81224,0
FL,Dragon Rises College Of Oriental Medicine,18040,21995,41000,81035,0
IA,Saint Luke'S Methodist Hospital School Of Radiologic Technology,18551,22360,40000,80911,0
FL,Atlantis University,80885,0,0,80885,0
WI,Midwest College Of Oriental Medicine,80513,0,0,80513,0
CA,Dominican School Of Philosophy And Theology,13676,23500,43000,80176,0
TX,Victoria Beauty College,79984,0,0,79984,0
CA,Theatre Of Arts,79898,0,0,79898,0
TX,Bk Cosmo College Of Cosmetology,79091,0,0,79091,0
OH,Moler Hollywood Beauty Academy,79077,0,0,79077,0
CA,Academy Of Esthetics And Cosmetology,79073,0,0,79073,0
CT,Paier College Of Art,78906,0,0,78906,0
NH,Paul Mitchell The School Portsmouth,78689,0,0,78689,0
LA,Opelousas School Of Cosmetology,78578,0,0,78578,0
ID,Rexburg College Of Massage Therapy,78561,0,0,78561,0
FL,Advance Science International College,78324,0,0,78324,0
MA,Fine Mortuary College,78045,0,0,78045,0
NV,Wongu University Of Oriental Medicine,14840,21995,41000,77835,0
AL,Alabama School Of Nail Technology & Cosmetology,77735,0,0,77735,0
VA,Esthetic Institute (The),77722,0,0,77722,0
MI,Ecumenical Theological Seminary,14258,22226,41000,77484,0
NY,Focus Personal Training Institute,77434,0,0,77434,0
IN,Pj'S College Of Cosmetology,77190,0,0,77190,0
MT,Butte Academy Of Beauty Culture,77189,0,0,77189,0
IN,Anabaptist Mennonite Biblical Seminary,12438,22444,42000,76882,0
NY,Saint Bernard'S School Of Theology And Ministry,13676,21958,41000,76634,0
IN,Indiana College Of Sports & Medical Massage,76551,0,0,76551,0
CA,Royale College Of Beauty And Barbering,76241,0,0,76241,0
CA,Universal College Of Beauty,76226,0,0,76226,0
KY,Jenny Lea Academy Of Cosmetology,76044,0,0,76044,0
NY,Sotheby'S Institute Of Art - Ny,75653,0,0,75653,0
SC,Construction Training Center,75525,0,0,75525,0
MI,Bayshire Beauty Academy,75520,0,0,75520,0
TX,Abc Beauty Academy,75257,0,0,75257,0
FL,Shear Finesse Beauty Academy,75116,0,0,75116,0
UT,Skinworks School Of Advanced Skincare,74698,0,0,74698,0
MO,Nazarene Theological Seminary,13954,21141,39000,74095,0
TX,Seguin Beauty School,74070,0,0,74070,0
NM,Vogue College Of Cosmetology,74042,0,0,74042,0
WI,Wisconsin School Of Professional Psychology,13967,21071,39000,74038,0
AZ,Charles Of Italy Beauty College,74036,0,0,74036,0
NY,Colgate Rochester Crozer Divinity School,13094,21299,39000,73393,0
FL,Florida Institute Of Ultrasound,73059,0,0,73059,0
PR,Caribbean Forensic & Technical College,72934,0,0,72934,0
WI,"Professional Hair Design Academy, The",72826,0,0,72826,0
MI,West Michigan College Of Barbering And Beauty,72745,0,0,72745,0
CO,Colorado School Of Healing Arts,72624,0,0,72624,0
CA,Wayne'S College Of Beauty,72461,0,0,72461,0
TX,Yahweh Beauty Academy,72253,0,0,72253,0
VA,Northern Virginia School Of Therapeutic Massage,71989,0,0,71989,0
SC,B-Unique Beauty And Barber Academy,71620,0,0,71620,0
ID,Evans Hairstyling College,71597,0,0,71597,0
NY,New York School Of Esthetics & Day Spa,71583,0,0,71583,0
MN,Hazelden Graduate School Of Addiction Studies,16012,19558,36000,71570,0
MI,Creative Hair School Of Cosmetology,71456,0,0,71456,0
CA,Advanced College,71329,0,0,71329,0
NV,European Massage Therapy School (The),71306,0,0,71306,0
UT,Mandalyn Academy,71253,0,0,71253,0
KY,Barrett & Company School Of Hair Design,70869,0,0,70869,0
CA,San Diego Culinary Institute,70731,0,0,70731,0
AL,University Academy Of Hair Design,70719,0,0,70719,0
WA,Inland Massage Institute,70663,0,0,70663,0
NY,New School Center For Media,70490,0,0,70490,0
CT,Branford Academy Of Hair & Cosmetology,70305,0,0,70305,0
OK,Enid Beauty College,70272,0,0,70272,0
NJ,Asi Career Institute,70108,0,0,70108,0
AL,Brown Beauty Barber School,70098,0,0,70098,0
OH,Ohio State School Of Cosmetology,70032,0,0,70032,0
KY,Lindsey Institute Of Cosmetology,69690,0,0,69690,0
NC,Carolina School Of Broadcasting,69411,0,0,69411,0
KY,Lexington Theological Seminary,7748,21480,40000,69228,0
OH,Toledo Academy Of Beauty Culture - East,69228,0,0,69228,0
MI,Hillsdale Beauty College,69128,0,0,69128,0
CA,Academy For Jewish Religion California,12221,19897,37000,69118,0
PA,Sharon Regional School Of Nursing,68940,0,0,68940,0
ND,Hair Academy (The),68765,0,0,68765,0
WI,Tricoci University Of Beauty Culture,68585,0,0,68585,0
MI,French Academy Of Cosmetology,68450,0,0,68450,0
VA,Dermal Science International Aesthetics & Nail Academy,68341,0,0,68341,0
TN,Arnold'S Beauty School,68240,0,0,68240,0
DE,Delaware Learning Institute Of Cosmetology,68172,0,0,68172,0
FL,Beauty Institute (The),67958,0,0,67958,0
FL,Med Academy,67956,0,0,67956,0
GA,Brown College Of Court Reporting,67945,0,0,67945,0
LA,Setting The Standard Barbering And Natural Hair Academy,67932,0,0,67932,0
AR,Academy Of Professional Cosmetology,67844,0,0,67844,0
TN,Love Beauty School,67806,0,0,67806,0
SC,Charleston Cosmetology Institute,67783,0,0,67783,0
HI,Ibs School Of Cosmetology And Massage,67672,0,0,67672,0
OK,Formations Institute Of Cosmetology & Barbering Llc,67651,0,0,67651,0
DC,Pontifical John Paul Ii Institute For Studies On Marriage And Family,12221,19424,36000,67645,0
IL,Bexley Seabury Seminary Federation,6110,21505,40000,67615,0
MN,"Cosmetology Careers Unlimited College Of Hair, Skin, And Nails",67512,0,0,67512,0
CA,California Beauty College,67420,0,0,67420,0
MO,Urshan Graduate School Of Theology,10234,20077,37000,67311,0
WA,Centralia Beauty College,66750,0,0,66750,0
MD,Maple Springs Baptist Bible College & Seminary,5620,21677,39000,66297,0
NY,Barber & Beauty Institute Of New York,66110,0,0,66110,0
WI,Salon Professional Academy (The),65719,0,0,65719,0
OR,Portland Actors Conservatory,15222,17450,33000,65672,0
TX,Center For Advanced Legal Studies,65587,0,0,65587,0
SC,Forrest College,65558,0,0,65558,0
OK,Totally Cosmo School Of Modern Cosmetology,65291,0,0,65291,0
OK,Beauty Technical College,65203,0,0,65203,0
NY,Orlo School Of Hair Design & Cosmetology (The),65152,0,0,65152,0
CA,Alhambra Medical University,65078,0,0,65078,0
NC,Beyond Measure Barbering Institute,65065,0,0,65065,0
IA,Faust Institute Of Cosmetology,65010,0,0,65010,0
PA,American Barber And Beauty Academy,64928,0,0,64928,0
OK,Ponca City Beauty College,64850,0,0,64850,0
MD,Robert Paul Academy Of Cosmetology Arts & Sciences,64827,0,0,64827,0
MI,Wright Beauty Academy,64647,0,0,64647,0
NY,Yeshiva Zichron Aryeh,14059,18253,32000,64312,0
TN,Omega Graduate School,10184,19096,35000,64280,0
TX,Advanced Beauty College,64217,0,0,64217,0
TX,International Beauty College #3,64097,0,0,64097,0
AR,New Beginnings Beauty Academy,63880,0,0,63880,0
FL,East West College Of Natural Medicine,63723,0,0,63723,0
MI,M.J. Murphy Beauty College,63536,0,0,63536,0
TX,Pathway Vocational Academy,63239,0,0,63239,0
TX,Salon Professional Academy (The),63166,0,0,63166,0
MA,New England School Of Photography,62906,0,0,62906,0
IL,Shear Learning Academy Of Cosmetology,62701,0,0,62701,0
PR,Quality Technical & Beauty College,62586,0,0,62586,0
CA,Capstone College,62462,0,0,62462,0
MO,House Of Heavilin Beauty College,62404,0,0,62404,0
WI,Advanced College Of Cosmetology,62265,0,0,62265,0
OK,Paul Mitchell The School Ardmore,61953,0,0,61953,0
LA,Baton Rouge School Of Computers,61790,0,0,61790,0
NY,Christ The King Seminary,11057,17714,33000,61771,0
NY,"School Of Professional Horticulture, N. Y. Botanical Garden",12767,17482,31000,61249,0
FL,Prestige Health & Beauty Sciences Academy,61112,0,0,61112,0
ID,Headmasters School Of Hair Design,61086,0,0,61086,0
NE,Creative Center (The),61073,0,0,61073,0
TX,Mission Beauty Institute,61068,0,0,61068,0
CA,Eagle Rock College,60954,0,0,60954,0
TN,Hair Academy The,60842,0,0,60842,0
IN,Don Roberts School Of Hair Design,60627,0,0,60627,0
MT,Bitterroot School Of Cosmetology,60612,0,0,60612,0
TN,Mister Wayne'S School Of Unisex Hair Design,60570,0,0,60570,0
FL,Lee Professional Institute,60437,0,0,60437,0
OR,Phagans' Medford Beauty School,60405,0,0,60405,0
MA,Rob Roy Academy,60343,0,0,60343,0
NY,Access Careers,60255,0,0,60255,0
OH,Winebrenner Theological Seminary,12366,16856,31000,60222,0
AR,Northern Technical College,59671,0,0,59671,0
CA,Bergin College Of Canine Studies,25825,33669,0,59494,0
TX,Texas Health And Science University,59416,0,0,59416,0
CA,Redondo Beach Beauty College,58790,0,0,58790,0
MO,American College Of Hair Design,58724,0,0,58724,0
MI,Nuvo College Of Cosmetology,58614,0,0,58614,0
KY,Lexington Healing Arts Academy,58500,0,0,58500,0
FL,Florida College Of Integrative Medicine,58486,0,0,58486,0
LA,Cloyd'S Beauty School #1,58274,0,0,58274,0
SC,Palmetto Beauty School,58220,0,0,58220,0
CO,Stacey James Institute,58169,0,0,58169,0
CA,Dell'Arte International School Of Physical Theatre,14549,15343,28000,57892,0
IA,American Hair Academy,57867,0,0,57867,0
DC,University Of The Potomac,57862,0,0,57862,0
MO,House Of Heavilin Of Blue Springs,57775,0,0,57775,0
IL,Niles School Of Cosmetology,57709,0,0,57709,0
MS,Delta Beauty College,57587,0,0,57587,0
DE,Academy Of Massage And Bodywork,57444,0,0,57444,0
MS,Foster'S Cosmetology College,57219,0,0,57219,0
OK,Southern School Of Beauty,57017,0,0,57017,0
NY,General Theological Seminary Of The Episcopal Church (The),10475,16375,30000,56850,0
SC,Aiken School Of Cosmetology And Barbering,56697,0,0,56697,0
LA,Omega Institute Of Cosmetology,56616,0,0,56616,0
IA,Iowa School Of Beauty,56508,0,0,56508,0
PA,Bucks County School Of Beauty Culture,55682,0,0,55682,0
FL,Ur Beauty & Barber Academy,55477,0,0,55477,0
UT,Paul Mitchell The School St. George,55312,0,0,55312,0
FL,Kaizen Beauty Academy,55217,0,0,55217,0
TX,Champion Beauty College,55136,0,0,55136,0
NM,"Avenue Academy, A Cosmetology Institute (The)",54745,0,0,54745,0
DE,Hair Academy School Of Barbering & Beauty,54631,0,0,54631,0
GA,Mak Beauty Institute,54557,0,0,54557,0
WA,International Beauty Education Center,54461,0,0,54461,0
MA,Massachusetts School Of Barbering,54414,0,0,54414,0
TX,Healthcare Institute (The),54372,0,0,54372,0
PA,Altoona Beauty School,54362,0,0,54362,0
NE,Universal College Of Healing Arts,54312,0,0,54312,0
CA,Modern Beauty Academy - Oxnard,54154,0,0,54154,0
IL,Oehrlein School Of Cosmetology,54088,0,0,54088,0
SC,Legrand Institute Of Cosmetology,54018,0,0,54018,0
AR,Professional Cosmetology Education Center,53985,0,0,53985,0
WV,Scott College Of Cosmetology,53972,0,0,53972,0
MN,Hastings Beauty School,53763,0,0,53763,0
MD,Omega Studios' School Of Applied Recording Arts & Sciences,53482,0,0,53482,0
NY,Empire Beauty School,53477,0,0,53477,0
NC,Carolina College Of Hair Design,53472,0,0,53472,0
VA,Avi Career Training,53197,0,0,53197,0
MD,Faith Theological Seminary,53194,0,0,53194,0
CA,Pacific States University,13385,13801,26000,53186,0
CO,Massage Therapy Institute Of Colorado,53176,0,0,53176,0
CA,Borner'S Barber College,53064,0,0,53064,0
MI,Lakewood School Of Therapeutic Massage,52948,0,0,52948,0
OR,Phagans' School Of Beauty,52869,0,0,52869,0
CA,Santa Ana Beauty Academy,52745,0,0,52745,0
IL,Mr. John'S School Of Cosmetology & Nails,52727,0,0,52727,0
MN,Avalon School Of Cosmetology,52436,0,0,52436,0
NV,L Makeup Institute,52324,0,0,52324,0
SD,Sanford Medical Center,13385,13736,25000,52121,0
UT,Evans Hairstyling College,52053,0,0,52053,0
GA,Augusta School Of Massage,52041,0,0,52041,0
OK,Family Of Faith Christian University,6040,16531,29000,51571,0
OH,Elite Academy Of Hair Design,51496,0,0,51496,0
AR,Arkansas Welding Academy,51346,0,0,51346,0
ME,Birthwise Midwifery School,51189,0,0,51189,0
MI,Princess Beauty School,51144,0,0,51144,0
MI,Sharp'S Academy Of Hairstyling,50808,0,0,50808,0
WI,State College Of Beauty Culture,50340,0,0,50340,0
KY,Ideal Beauty Academy,50189,0,0,50189,0
CA,Franciscan School Of Theology,7856,14789,27000,49645,0
TX,Total Transformation Institute Of Cosmetology,49523,0,0,49523,0
LA,Blalock'S Professional Beauty College,48933,0,0,48933,0
FL,Global Medical & Technical Training Institute,48533,0,0,48533,0
IN,Alexandria School Of Scientific Therapeutics,48376,0,0,48376,0
LA,Vh Barber & Styling Academy,48247,0,0,48247,0
CO,New Dimensions Beauty Academy,48218,0,0,48218,0
TX,Mid Cities Barber College,48082,0,0,48082,0
CO,Institute Of Taoist Education And Acupuncture,11057,12975,24000,48032,0
WV,Mountain State School Of Massage,47967,0,0,47967,0
IL,Cannella School Of Hair Design,47966,0,0,47966,0
CT,Tigi Hairdressing Academy Guilford,47853,0,0,47853,0
NE,Myotherapy Institute,47524,0,0,47524,0
NH,Keene Beauty Academy,47439,0,0,47439,0
SC,Top Of The Line Barber College,47386,0,0,47386,0
AZ,American Institute Of Interior Design,47278,0,0,47278,0
PA,Champ'S Barber School,47263,0,0,47263,0
TX,Culinary School Of Fort Worth (The),47260,0,0,47260,0
TN,Career Beauty College,47255,0,0,47255,0
CA,Abco Technology,46979,0,0,46979,0
IL,Creative Touch Cosmetology School,46816,0,0,46816,0
VT,Advanced Welding Institute,46587,0,0,46587,0
OH,Tiffin Academy Of Hair Design,46336,0,0,46336,0
IL,Professionals Choice Hair Design Academy,46213,0,0,46213,0
IL,Curve Metric School Of Hair Design,46054,0,0,46054,0
TX,American College Of Acupuncture & Oriental Medicine,45939,0,0,45939,0
VA,Luckes Beauty Academy,45259,0,0,45259,0
LA,Cloyd'S Barber School #2,44745,0,0,44745,0
IL,Cannella School Of Hair Design,44650,0,0,44650,0
MO,New Dimension School Of Hair Design,44577,0,0,44577,0
NC,Center For Massage & Natural Health,44551,0,0,44551,0
OK,River Valley Cosmetology Institute,44407,0,0,44407,0
FL,Millennia Atlantic University,44229,0,0,44229,0
TX,Aoma Graduate School Of Integrative Medicine,44228,0,0,44228,0
MA,Jupiter Beauty Academy,44219,0,0,44219,0
KY,Regina Webb Academy,44105,0,0,44105,0
TX,William Edge Institute,44088,0,0,44088,0
PA,Divine Crown Barber & Beauty Academy,44060,0,0,44060,0
GA,Institute Of Medical Ultrasound,43581,0,0,43581,0
MT,Academy Of Cosmetology,43527,0,0,43527,0
OH,Apex Academy Hair Skin Nails School Of Cosmetology,43429,0,0,43429,0
IL,University Of Aesthetics & Cosmetology,43036,0,0,43036,0
CA,Dehart Technical School,42994,0,0,42994,0
IN,Textures Institute Of Cosmetology,42921,0,0,42921,0
AR,Arkansas Beauty College,42819,0,0,42819,0
AR,"Beauty School, (The)",42726,0,0,42726,0
PR,Colegio Técnico De Electricidad Galloza,42670,0,0,42670,0
NH,Upper Valley Educators Institute,8729,16699,17000,42428,0
PA,Lehigh Valley Barber School,42426,0,0,42426,0
NH,Continental Academie Of Hair Design,42043,0,0,42043,0
NJ,Advantage Career Institute,41609,0,0,41609,0
IL,Gem City College,41594,0,0,41594,0
KY,Kentucky Horseshoeing School,41510,0,0,41510,0
PA,Fountain Of Youth Academy Of Cosmetology,41507,0,0,41507,0
IL,Hair Professionals Career College,41496,0,0,41496,0
PA,Lansdale School Of Cosmetology,41255,0,0,41255,0
TX,Salon Professional Academy Of San Antonio (The),41200,0,0,41200,0
PA,Reconstructionist Rabbinical College,8438,11390,21000,40828,0
PA,Welder Training & Testing Institute,40685,0,0,40685,0
IL,Steven Papageorge Hair Academy,40486,0,0,40486,0
TN,North Central Institute,40259,0,0,40259,0
VA,Virginia School Of Hair Design,40047,0,0,40047,0
NY,Alliance Computing Solutions,40031,0,0,40031,0
CA,Sacramento Ultrasound Institute,39829,0,0,39829,0
NY,Memorial Sloan Kettering Cancer Center,7585,11233,21000,39818,0
OR,Sage School Of Massage & Esthetics,39511,0,0,39511,0
MO,Neosho Beauty College,39487,0,0,39487,0
TX,K&G 5 Star Barber College,39446,0,0,39446,0
MI,Port Huron Cosmetology College,39026,0,0,39026,0
MI,U.S. Truck Driver Training School,38918,0,0,38918,0
TX,Strand Institute Of Beauty & Esthetics (The),38506,0,0,38506,0
NY,Anousheh School Of Hair,38286,0,0,38286,0
FL,American Beauty Schools,38193,0,0,38193,0
IL,University Of Aesthetics & Cosmetology (The),37971,0,0,37971,0
VA,Another Level Barbering And Cosmetology School,37931,0,0,37931,0
AZ,Kor Beauty Academy,37326,0,0,37326,0
AZ,Phoenix Institute Of Herbal Medicine & Acupuncture,37245,0,0,37245,0
TX,Buckner Barber School,37184,0,0,37184,0
FL,Merryfield School Of Pet Grooming,37149,0,0,37149,0
TX,Pipo Academy Of Hair Design,37076,0,0,37076,0
LA,Ray J'S College Of Hair,36978,0,0,36978,0
CA,High Tech High Graduate School Of Education,6110,10792,20000,36902,0
AR,Velvatex College Of Beauty Culture,36831,0,0,36831,0
MD,Holistic Massage Training Institute,36599,0,0,36599,0
ID,Urban 113 School Of Cosmetology,36448,0,0,36448,0
PA,European Medical School Of Massage,36317,0,0,36317,0
PA,"Workforce Institute'S City College, The",17617,18063,0,35680,0
CA,California Institute Of Medical Science,35107,0,0,35107,0
AZ,Roberto-Venn School Of Luthiery,35092,0,0,35092,0
MS,Wesley Biblical Seminary,4013,11034,20000,35047,0
CA,San Francisco Film School,34950,0,0,34950,0
IN,Bethany Theological Seminary,5547,10344,19000,34891,0
TN,Allied Health Careers Institute,34679,0,0,34679,0
IA,La' James International College,34528,0,0,34528,0
IN,John Patrick University Of Health And Applied Sciences,34392,0,0,34392,0
MI,Marketti Academy Of Cosmetology,34387,0,0,34387,0
NH,American Academy Of Health And Beauty,34010,0,0,34010,0
CO,Academy Of Natural Therapy,33501,0,0,33501,0
UT,Top Nails & Hair Beauty School,33446,0,0,33446,0
IA,La' James International College - Des Moines,33414,0,0,33414,0
KY,Tri-State Barber College,33384,0,0,33384,0
IN,Knox Beauty College,32917,0,0,32917,0
AZ,Pure Aesthetics Natural Skincare School,32907,0,0,32907,0
CO,Colorado School Of Traditional Chinese Medicine,32880,0,0,32880,0
SD,Avera Mckennan Hospital,6110,9372,17000,32482,0
MA,Rob Roy Academy,32113,0,0,32113,0
OK,Yukon Beauty College,31965,0,0,31965,0
OH,Us Grant Joint Vocational School,6833,25117,0,31950,0
IL,Innovations Design Academy,31827,0,0,31827,0
AZ,School Of Architecture At Taliesin (The),3492,9577,18000,31069,0
NY,Charles Stuart School,30844,0,0,30844,0
VA,Institute Of Advanced Medical Esthetics,30626,0,0,30626,0
MO,Ea La Mar'S Cosmetology & Barber College,30499,0,0,30499,0
MO,Lebanon College Of Cosmetology,30034,0,0,30034,0
CA,Blush School Of Makeup,29877,0,0,29877,0
MI,Cadillac Institute Of Cosmetology,29719,0,0,29719,0
NY,Leon Studio One School Of Beauty Knowledge,29227,0,0,29227,0
WI,Bella Academy Of Cosmetology,29101,0,0,29101,0
TX,Allgood Beauty Institute,29054,0,0,29054,0
MI,Brighton Institute Of Cosmetology,29053,0,0,29053,0
CO,Aspen University,28984,0,0,28984,0
MA,Rob Roy Academy,28869,0,0,28869,0
TN,Mind Body Institute,28782,0,0,28782,0
VA,Suffolk Beauty Academy,28655,0,0,28655,0
IA,La' James International College,28646,0,0,28646,0
SD,Avera Sacred Heart Hospital School Of Radiologic Technology,6983,7599,14000,28582,0
VA,Staunton School Of Cosmetology,28378,0,0,28378,0
CO,National Beauty College,28336,0,0,28336,0
TN,Franklin Hair Academy School Of Cosmetology,28291,0,0,28291,0
AL,Alabama State College Of Barber Styling,28259,0,0,28259,0
MS,Unlimited Cosmetology School,28162,0,0,28162,0
NH,New England School Of Hair Design,27906,0,0,27906,0
ID,College Of Massage Therapy,27849,0,0,27849,0
TN,Master'S Barber & Styling College,27762,0,0,27762,0
MO,Evolve Beauty Academy,27103,0,0,27103,0
NC,Daoist Traditions College Of Chinese Medical Arts,27061,0,0,27061,0
WI,Wright Graduate University For The Realization Of Human Potential,5238,7786,14000,27024,0
NM,Southwest Acupuncture College,26770,0,0,26770,0
TN,Massage Institute Of Memphis (The),26324,0,0,26324,0
SC,Sumter Beauty College,24772,0,0,24772,0
CT,Belle Academy Of Cosmetology,24212,0,0,24212,0
WA,Seattle Institute Of East Asian Medicine,24151,0,0,24151,0
MA,Eine Electrology/Esthetics Institute Of Ne,23996,0,0,23996,0
FL,Worldclass Academy Of Beauty Careers,23877,0,0,23877,0
ND,Lynnes Welding Training,23803,0,0,23803,0
IA,Carlson College Of Massage Therapy,23609,0,0,23609,0
CA,California Career School,23569,0,0,23569,0
MA,Conway School Of Landscape Design,6692,5869,11000,23561,0
VA,Sovah School Of Health Professions,23286,0,0,23286,0
CA,American Baptist Seminary Of The West,9311,13958,0,23269,0
NJ,Rizzieri Institute,23111,0,0,23111,0
LA,Learning Bridge Career Institute,22916,0,0,22916,0
IA,La'James International College,22241,0,0,22241,0
FL,Center For Neurosomatic Studies,21825,0,0,21825,0
MN,American Academy Of Traditional Chinese Medicine,21532,0,0,21532,0
PR,Rosslyn Training Academy Of Cosmetology,21345,0,0,21345,0
PA,Theological Seminary Reformed Episcopal Church,4074,6200,11000,21274,0
TX,"Recording Conservatory Of Austin, (The)",20622,0,0,20622,0
CA,Beverly Hills Design Institute,20598,0,0,20598,0
PA,Reformed Presbyterian Theological Seminary,20401,0,0,20401,0
NJ,Eastern School Of Acupuncture And Traditional Medicine,19495,0,0,19495,0
MA,Bancroft School Of Massage Therapy,19166,0,0,19166,0
CA,Saybrook University,3469,5623,10000,19092,0
IL,Tri County Beauty Academy,18823,0,0,18823,0
OH,Pioneer Career And Technology Center: A Vocational School District,2969,5671,10000,18640,0
PA,Byzantine Catholic Seminary Of Saints Cyril And Methodius,3022,5585,10000,18607,0
VA,Virginia Beach Theological Seminary,3070,5421,10000,18491,0
TX,Bakke Graduate University,2662,5600,10000,18262,0
IN,Vincennes Beauty College,18044,0,0,18044,0
NY,Lia Schorr Institute Of Cosmetic Skin Care Training,16952,0,0,16952,0
NY,Berkowits School Of Electrolysis,16632,0,0,16632,0
TX,Gemini School Of Visual Arts & Communication,16326,0,0,16326,0
CA,Sofia University,16303,0,0,16303,0
NH,New Hampshire Institute For Therapeutic Arts,16274,0,0,16274,0
IA,La' James International College,15386,0,0,15386,0
FL,Kck Beauty & Barber Academy,15023,0,0,15023,0
NJ,American Institute Of Alternative Medicine,14814,0,0,14814,0
HI,Institute Of Clinical Acupuncture And Oriental Medicine,14549,0,0,14549,0
CO,Montessori Casa International,3492,4016,7000,14508,0
IN,Christina And Company Education Center,14023,0,0,14023,0
WI,East-West Healing Arts Institute,13994,0,0,13994,0
FL,Jose Maria Vargas University,13814,0,0,13814,0
CA,Meridian University,13758,0,0,13758,0
NY,Christie'S Education,13385,0,0,13385,0
CA,United States University,12982,0,0,12982,0
FL,Unilatina International College,11930,0,0,11930,0
AR,River Valley School Of Massage,11895,0,0,11895,0
ID,Academy Di Firenze,9836,0,0,9836,0
CA,Los Angeles Academy Of Figurative Art,9263,0,0,9263,0
FL,Installer Institute,8619,0,0,8619,0
CA,Brand College,8147,0,0,8147,0
UT,Bonnie Joseph Academy Of Cosmetology & Barbering,7948,0,0,7948,0
AZ,Arizona School Of Acupuncture And Oriental Medicine,7856,0,0,7856,0
MI,Dsdt,7856,0,0,7856,0
NY,Studio Jewelers,7528,0,0,7528,0
CA,Westchester College Of Nursing & Allied Health,6110,0,0,6110,0
HI,Mauna Loa Helicopters,6110,0,0,6110,0
FL,Pets Playground Grooming School,5656,0,0,5656,0
TX,Vogue International Academy,5534,0,0,5534,0
IA,American College Of Hairstyling-Des Moines,5528,0,0,5528,0
NJ,Mobile Technical Training,5238,0,0,5238,0
NC,Anson College Of Cosmetology,3468,0,0,3468,0
VA,University Of Management And Technology (The),2694,0,0,2694,0
CA,Ashford University,1001,0,0,1001,0
PA,Professional Academy Of Cosmetology,873,0,0,873,0
NV,Institute Of Professional Careers,291,0,0,291,0
